Rk,Player,Nation,Pos,Squad,Age,Born,90s,Tackles_Tkl,Tackles_TklW,Tackles_Def_3rd,Tackles_Mid_3rd,Tackles_Att_3rd,Challenges_Tkl,Challenges_Att,Challenges_Tkl%,Challenges_Lost,Blocks_Blocks,Blocks_Sh,Blocks_Pass,Int,Tkl+Int,Clr,Err,Matches
1,Pape Abou Cissé,sn SEN,DF,gr Olympiacos,24,1995,5.0,8,2,5,3,0,1,2,50.0,1,8,7,1,17,25,20,0,Matches
2,Tammy Abraham,eng ENG,FW,eng Chelsea,22,1997,2.6,0,0,0,0,0,0,0,,0,2,1,1,1,1,2,0,Matches
3,Francesco Acerbi,it ITA,DF,it Lazio,32,1988,8.0,15,8,9,6,0,6,9,66.7,3,9,6,3,11,26,25,0,Matches
4,Marcos Acuña,ar ARG,DF,es Sevilla,28,1991,3.6,9,8,6,1,2,3,4,75.0,1,7,0,7,3,12,5,0,Matches
5,Tyler Adams,us USA,"FW,MF",de RB Leipzig,21,1999,3.2,7,5,3,4,0,4,8,50.0,4,3,0,3,5,12,3,0,Matches
6,Karim Adeyemi,de GER,FW,at RB Salzburg,18,2002,0.6,0,0,0,0,0,0,0,,0,1,0,1,0,0,0,0,Matches
7,Adrián,es ESP,GK,eng Liverpool,33,1987,1.0,0,0,0,0,0,0,0,,0,0,0,0,0,0,1,1,Matches
8,Nayef Aguerd,ma MAR,DF,fr Rennes,24,1996,3.1,1,1,1,0,0,0,0,,0,4,2,2,4,5,9,1,Matches
9,Sergio Agüero,ar ARG,FW,eng Manchester City,32,1988,1.7,1,0,1,0,0,0,1,0.0,1,2,0,2,0,1,0,0,Matches
10,Manuel Akanji,ch SUI,DF,de Dortmund,25,1995,7.0,12,5,8,4,0,4,11,36.4,7,9,3,6,8,20,16,0,Matches
11,Marley Aké,fr FRA,"FW,MF",fr Marseille,19,2001,0.4,0,0,0,0,0,0,0,,0,1,0,1,0,0,0,0,Matches
12,Nathan Aké,nl NED,DF,eng Manchester City,25,1995,2.0,3,3,2,0,1,3,4,75.0,1,1,0,1,3,6,4,0,Matches
13,Jean-Daniel Akpa-Akpro,ci CIV,MF,it Lazio,27,1992,3.2,8,4,3,5,0,3,6,50.0,3,4,1,3,7,15,4,0,Matches
14,David Alaba,at AUT,"DF,MF",de Bayern Munich,28,1992,9.0,14,7,6,8,0,5,7,71.4,2,8,3,5,14,28,19,1,Matches
15,Jordi Alba,es ESP,DF,es Barcelona,31,1989,5.4,5,5,1,4,0,2,5,40.0,3,4,2,2,6,11,6,0,Matches
16,Luis Alberto,es ESP,MF,it Lazio,27,1992,5.3,17,5,9,3,5,6,21,28.6,15,5,2,3,4,21,2,0,Matches
17,Thiago Alcántara,es ESP,MF,eng Liverpool,29,1991,2.5,10,8,5,3,2,1,2,50.0,1,4,1,3,3,13,5,1,Matches
18,Danijel Aleksić,rs SRB,MF,tr Başakşehir,29,1991,1.2,0,0,0,0,0,0,3,0.0,3,2,0,2,0,0,1,0,Matches
19,Carles Aleñá,es ESP,"MF,DF",es Barcelona,22,1998,1.4,1,1,0,1,0,0,2,0.0,2,2,2,0,0,1,2,0,Matches
20,Trent Alexander-Arnold,eng ENG,DF,eng Liverpool,21,1998,7.9,10,4,7,3,0,6,12,50.0,6,5,0,5,12,22,9,2,Matches
21,Hasan Ali Kaldırım,tr TUR,DF,tr Başakşehir,30,1989,1.2,1,0,0,1,0,1,1,100.0,0,5,2,3,1,2,2,0,Matches
22,Alisson,br BRA,GK,eng Liverpool,27,1992,7.0,1,0,1,0,0,1,1,100.0,0,0,0,0,0,1,4,0,Matches
23,Marcos Alonso,es ESP,DF,eng Chelsea,29,1990,2.0,1,1,1,0,0,1,1,100.0,0,3,0,3,0,1,4,0,Matches
24,Éder Álvarez Balanta,co COL,MF,be Club Brugge,27,1993,2.6,2,0,2,0,0,1,7,14.3,6,3,2,1,4,6,5,0,Matches
25,Edson Álvarez,mx MEX,"MF,DF",nl Ajax,22,1997,1.4,3,0,1,1,1,0,1,0.0,1,3,2,1,3,6,5,0,Matches
26,Jordan Amavi,fr FRA,DF,fr Marseille,26,1994,5.0,8,7,5,3,0,4,8,50.0,4,2,1,1,10,18,6,0,Matches
27,Mikkel Andersen,dk DEN,GK,dk Midtjylland,31,1988,2.0,0,0,0,0,0,0,0,,0,0,0,0,0,0,0,0,Matches
28,Felipe Anderson,br BRA,FW,pt Porto,27,1993,0.7,1,1,0,1,0,0,2,0.0,2,1,0,1,4,5,0,0,Matches
29,Mikael Anderson,is ISL,"MF,FW",dk Midtjylland,22,1998,1.9,6,3,3,3,0,0,2,0.0,2,1,0,1,2,8,3,0,Matches
30,Joel Andersson,se SWE,DF,dk Midtjylland,23,1996,4.4,7,6,4,3,0,3,6,50.0,3,4,0,4,9,16,6,0,Matches
31,Oleksandr Andriyevskyi,ua UKR,MF,ua Dynamo Kyiv,26,1994,1.4,3,1,2,1,0,0,2,0.0,2,1,0,1,2,5,3,0,Matches
32,Angeliño,es ESP,"DF,FW",de RB Leipzig,23,1997,7.0,15,7,7,7,1,7,10,70.0,3,8,0,8,2,17,6,0,Matches
33,Faustino Anjorin,eng ENG,FW,eng Chelsea,18,2001,0.9,4,3,0,2,2,1,1,100.0,0,1,0,1,0,4,0,0,Matches
34,Marcos Antônio,br BRA,MF,ua Shakhtar,20,2000,2.7,2,1,1,1,0,2,3,66.7,1,5,1,4,2,4,1,0,Matches
35,Antony,br BRA,FW,nl Ajax,20,2000,4.0,7,3,4,3,0,0,9,0.0,9,7,1,6,3,10,2,0,Matches
36,Youssef El-Arabi,ma MAR,FW,gr Olympiacos,33,1987,4.7,1,0,0,1,0,1,3,33.3,2,1,1,0,1,2,4,0,Matches
37,Ronald Araújo,uy URU,DF,es Barcelona,21,1999,1.6,6,3,4,2,0,3,4,75.0,1,2,0,2,2,8,2,0,Matches
38,Ari,ru RUS,FW,ru Krasnodar,34,1985,0.3,0,0,0,0,0,0,0,,0,0,0,0,0,0,0,0,Matches
39,Bright Arrey-Mbi,de GER,DF,de Bayern Munich,17,2003,0.7,0,0,0,0,0,0,0,,0,0,0,0,0,0,1,0,Matches
40,Sergio Arribas,es ESP,FW,es Real Madrid,18,2001,0.4,0,0,0,0,0,0,1,0.0,1,0,0,0,0,0,0,0,Matches
41,Kepa Arrizabalaga,es ESP,GK,eng Chelsea,25,1994,1.0,0,0,0,0,0,0,0,,0,0,0,0,0,0,0,0,Matches
42,Marco Asensio,es ESP,FW,es Real Madrid,24,1996,6.9,6,6,2,1,3,3,7,42.9,4,5,0,5,4,10,0,0,Matches
43,Majeed Ashimeru,gh GHA,MF,at RB Salzburg,22,1997,0.5,2,2,0,1,1,2,3,66.7,1,1,0,1,1,3,0,0,Matches
44,Sardar Azmoun,ir IRN,FW,ru Zenit,25,1995,3.2,0,0,0,0,0,0,2,0.0,2,1,0,1,1,1,3,0,Matches
45,César Azpilicueta,es ESP,DF,eng Chelsea,30,1989,10.7,26,14,14,11,1,16,23,69.6,7,21,9,12,11,37,31,0,Matches
46,Demba Ba,sn SEN,FW,tr Başakşehir,35,1985,3.6,1,0,0,1,0,0,4,0.0,4,1,1,0,2,3,2,0,Matches
47,Ousseynou Ba,sn SEN,DF,gr Olympiacos,24,1995,2.1,5,3,5,0,0,1,5,20.0,4,2,1,1,1,6,12,0,Matches
48,Youssouph Badji,sn SEN,FW,be Club Brugge,18,2001,0.4,0,0,0,0,0,0,1,0.0,1,1,1,0,0,0,0,0,Matches
49,Mitchel Bakker,nl NED,DF,fr Paris S-G,20,2000,4.6,7,6,3,3,1,3,7,42.9,4,2,0,2,4,11,13,1,Matches
50,Leonardo Balerdi,ar ARG,DF,fr Marseille,21,1999,2.8,2,0,1,1,0,1,3,33.3,2,2,1,1,7,9,2,0,Matches
51,Tudor Băluță,ro ROU,MF,ua Dynamo Kyiv,21,1999,0.1,0,0,0,0,0,0,0,,0,1,1,0,1,1,0,0,Matches
52,Nicolò Barella,it ITA,MF,it Inter,23,1997,5.9,14,11,2,9,3,4,15,26.7,11,4,0,4,6,20,0,0,Matches
53,Romário Baró,pt POR,MF,pt Porto,20,2000,0.7,1,0,0,1,0,1,3,33.3,2,0,0,0,1,2,2,0,Matches
54,Wílmar Barrios,co COL,MF,ru Zenit,26,1993,5.5,12,9,10,2,0,6,14,42.9,8,9,4,5,15,27,10,0,Matches
55,Alessandro Bastoni,it ITA,DF,it Inter,21,1999,4.6,5,2,3,2,0,3,7,42.9,4,1,0,1,4,9,8,0,Matches
56,Roko Baturina,hr CRO,FW,hu Ferencváros,20,2000,0.4,0,0,0,0,0,0,0,,0,0,0,0,0,0,0,0,Matches
57,Donny van de Beek,nl NED,"MF,FW",eng Manchester Utd,23,1997,3.1,5,2,1,0,4,2,3,66.7,1,2,0,2,2,7,1,0,Matches
58,Jude Bellingham,eng ENG,MF,de Dortmund,17,2003,7.6,24,9,7,9,8,8,16,50.0,8,19,2,17,5,29,8,0,Matches
59,Darío Benedetto,ar ARG,FW,fr Marseille,30,1990,2.9,1,1,1,0,0,0,0,,0,3,0,3,0,1,2,0,Matches
60,László Bénes,sk SVK,MF,de Gladbach,22,1997,0.2,0,0,0,0,0,0,1,0.0,1,0,0,0,0,0,0,0,Matches
61,Ramy Bensebaini,dz ALG,DF,de Gladbach,25,1995,5.0,15,9,10,5,0,10,16,62.5,6,10,0,10,11,26,19,2,Matches
62,Rodrigo Bentancur,uy URU,MF,it Juventus,23,1997,5.2,13,12,5,8,0,6,10,60.0,4,8,1,7,10,23,9,1,Matches
63,Karim Benzema,fr FRA,FW,es Real Madrid,32,1987,9.3,8,2,1,5,2,2,3,66.7,1,3,1,2,2,10,2,0,Matches
64,Marcus Berg,se SWE,FW,ru Krasnodar,33,1986,5.7,3,1,0,2,1,2,7,28.6,5,5,0,5,2,5,4,0,Matches
65,Mergim Berisha,de GER,"MF,FW",at RB Salzburg,22,1998,5.2,1,1,1,0,0,0,8,0.0,8,2,0,2,3,4,2,0,Matches
66,Federico Bernardeschi,it ITA,"MF,FW",it Juventus,26,1994,1.7,2,1,1,0,1,0,0,,0,1,0,1,2,4,3,0,Matches
67,Miha Blažič,si SVN,DF,hu Ferencváros,27,1993,6.0,5,3,3,2,0,2,7,28.6,5,5,3,2,16,21,21,0,Matches
68,Daley Blind,nl NED,"DF,MF",nl Ajax,30,1990,4.6,9,5,1,8,0,2,6,33.3,4,5,2,3,5,14,14,2,Matches
69,Jérôme Boateng,de GER,DF,de Bayern Munich,31,1988,5.8,15,6,9,5,1,9,13,69.2,4,9,5,4,14,29,17,0,Matches
70,Franck Boli,ci CIV,FW,hu Ferencváros,26,1993,0.9,1,1,0,0,1,0,0,,0,0,0,0,0,1,0,0,Matches
71,Boli Bolingoli-Mbombo,be BEL,DF,tr Başakşehir,25,1995,4.1,4,1,3,0,1,3,6,50.0,3,11,4,7,9,13,9,0,Matches
72,Valerii Bondar,ua UKR,DF,ua Shakhtar,21,1999,6.0,6,4,5,1,0,4,7,57.1,3,13,6,7,10,16,33,0,Matches
73,Leonardo Bonucci,it ITA,DF,it Juventus,33,1987,5.5,5,1,2,3,0,3,5,60.0,2,2,2,0,8,13,9,0,Matches
74,Endre Botka,hu HUN,DF,hu Ferencváros,25,1994,2.9,1,0,0,0,1,0,3,0.0,3,5,3,2,5,6,5,0,Matches
75,Andreas Bouchalakis,gr GRE,MF,gr Olympiacos,27,1993,4.6,7,1,0,6,1,3,8,37.5,5,5,1,4,9,16,3,2,Matches
76,Yassine Bounou,ma MAR,GK,es Sevilla,29,1991,5.0,0,0,0,0,0,0,0,,0,0,0,0,0,0,0,0,Matches
77,Benjamin Bourigeaud,fr FRA,MF,fr Rennes,26,1994,4.1,4,2,2,1,1,2,13,15.4,11,7,1,6,5,9,6,0,Matches
78,Denys Boyko,ua UKR,GK,ua Dynamo Kyiv,32,1988,1.0,0,0,0,0,0,0,0,,0,0,0,0,0,0,0,0,Matches
79,Martin Braithwaite,dk DEN,FW,es Barcelona,29,1991,2.6,1,0,0,0,1,0,1,0.0,1,2,0,2,0,1,1,0,Matches
80,Julian Brandt,de GER,MF,de Dortmund,24,1996,2.4,4,2,2,2,0,2,4,50.0,2,0,0,0,0,4,4,0,Matches
81,Brian Brobbey,nl NED,FW,nl Ajax,18,2002,0.5,1,1,0,0,1,0,0,,0,0,0,0,0,1,0,0,Matches
82,Marcelo Brozović,hr CRO,MF,it Inter,27,1992,4.1,6,3,1,3,2,1,7,14.3,6,12,3,9,4,10,0,0,Matches
83,Bruma,pt POR,"FW,MF",gr Olympiacos,25,1994,0.7,0,0,0,0,0,0,1,0.0,1,1,0,1,0,0,0,0,Matches
84,Gianluigi Buffon,it ITA,GK,it Juventus,42,1978,1.0,0,0,0,0,0,0,0,,0,0,0,0,0,0,0,0,Matches
85,Roman Bürki,ch SUI,GK,de Dortmund,29,1990,4.0,0,0,0,0,0,0,0,,0,0,0,0,1,1,0,0,Matches
86,Heorhiy Bushchan,ua UKR,GK,ua Dynamo Kyiv,26,1994,4.0,0,0,0,0,0,0,0,,0,0,0,0,1,1,6,2,Matches
87,Sergio Busquets,es ESP,MF,es Barcelona,32,1988,3.7,8,3,2,3,3,5,12,41.7,7,3,0,3,1,9,1,0,Matches
88,Vitaliy Buyalskyi,ua UKR,"FW,MF",ua Dynamo Kyiv,27,1993,3.8,9,6,5,4,0,4,11,36.4,7,4,0,4,4,13,0,0,Matches
89,Rémy Cabella,fr FRA,"MF,FW",ru Krasnodar,30,1990,2.8,6,4,1,4,1,0,5,0.0,5,3,1,2,0,6,0,0,Matches
90,Júnior Caiçara,br BRA,DF,tr Başakşehir,31,1989,0.3,0,0,0,0,0,0,0,,0,1,1,0,0,0,3,0,Matches
91,Felipe Caicedo,ec ECU,FW,it Lazio,31,1988,1.5,0,0,0,0,0,0,0,,0,0,0,0,0,0,0,0,Matches
92,Jens Cajuste,se SWE,MF,dk Midtjylland,20,1999,3.6,7,5,3,3,1,3,9,33.3,6,8,2,6,5,12,3,1,Matches
93,Mattia Caldara,it ITA,MF,it Atalanta,26,1994,0.1,0,0,0,0,0,0,0,,0,0,0,0,0,0,0,0,Matches
94,Duje Ćaleta-Car,hr CRO,DF,fr Marseille,23,1996,4.0,3,1,3,0,0,1,3,33.3,2,3,3,0,5,8,14,0,Matches
95,Mohamed Camara,gn GUI,MF,gr Olympiacos,23,1997,3.2,9,3,4,5,0,3,9,33.3,6,0,0,0,0,9,0,0,Matches
96,Mohamed Camara,ml MLI,MF,at RB Salzburg,20,2000,4.6,15,8,4,9,2,7,19,36.8,12,10,0,10,11,26,2,0,Matches
97,Eduardo Camavinga,fr FRA,MF,fr Rennes,17,2002,3.6,6,3,0,3,3,2,9,22.2,7,4,2,2,6,12,1,0,Matches
98,Sergio Camello,es ESP,FW,es Atlético Madrid,19,2001,0.1,0,0,0,0,0,0,0,,0,0,0,0,0,0,0,0,Matches
99,Emre Can,de GER,"MF,DF",de Dortmund,26,1994,5.2,7,5,5,2,0,3,8,37.5,5,11,7,4,5,12,13,1,Matches
100,João Cancelo,pt POR,DF,eng Manchester City,26,1994,6.7,24,17,9,10,5,11,20,55.0,9,2,0,2,6,30,8,1,Matches
101,Diego Carlos,br BRA,DF,es Sevilla,27,1993,8.0,9,6,4,4,1,3,5,60.0,2,9,4,5,12,21,25,1,Matches
102,Yannick Carrasco,be BEL,"MF,DF",es Atlético Madrid,26,1993,4.2,4,2,2,0,2,4,5,80.0,1,4,0,4,1,5,3,0,Matches
103,Dani Carvajal,es ESP,DF,es Real Madrid,28,1992,1.8,3,1,0,0,3,2,2,100.0,0,3,0,3,2,5,1,0,Matches
104,Casemiro,br BRA,MF,es Real Madrid,28,1992,9.2,23,13,11,12,0,8,25,32.0,17,18,3,15,18,41,12,0,Matches
105,Danilo Cataldi,it ITA,MF,it Lazio,25,1994,1.0,1,0,1,0,0,0,3,0.0,3,1,0,1,1,2,1,0,Matches
106,Edinson Cavani,uy URU,FW,eng Manchester Utd,33,1987,2.3,1,0,0,1,0,1,3,33.3,2,2,0,2,0,1,0,0,Matches
107,Murilo Cerqueira,br BRA,DF,ru Loko Moscow,23,1997,5.0,6,5,3,3,0,3,6,50.0,3,8,2,6,11,17,43,1,Matches
108,Nacer Chadli,be BEL,MF,tr Başakşehir,30,1989,1.3,0,0,0,0,0,0,1,0.0,1,5,0,5,0,0,0,0,Matches
109,Yevgeni Chernov,ru RUS,DF,ru Krasnodar,27,1992,3.2,1,0,0,1,0,1,2,50.0,1,3,3,0,3,4,10,0,Matches
110,Giorgio Chiellini,it ITA,DF,it Juventus,35,1984,1.6,1,1,1,0,0,1,2,50.0,1,0,0,0,2,3,5,1,Matches
111,Federico Chiesa,it ITA,"MF,FW",it Juventus,22,1997,6.1,9,5,3,3,3,3,12,25.0,9,5,0,5,1,10,4,0,Matches
112,Ben Chilwell,eng ENG,"DF,FW",eng Chelsea,23,1996,8.6,11,6,7,2,2,8,19,42.1,11,7,0,7,15,26,31,1,Matches
113,Andreas Christensen,dk DEN,DF,eng Chelsea,24,1996,6.6,3,2,0,3,0,2,5,40.0,3,4,4,0,10,13,21,0,Matches
114,Eldar Ćivić,ba BIH,DF,hu Ferencváros,24,1996,0.7,4,2,3,1,0,3,7,42.9,4,2,0,2,2,6,1,0,Matches
115,Viktor Claesson,se SWE,"FW,MF",ru Krasnodar,28,1992,3.2,2,1,0,2,0,1,7,14.3,6,6,0,6,6,8,2,0,Matches
116,Leighton Clarkson,eng ENG,MF,eng Liverpool,18,2001,1.0,0,0,0,0,0,0,3,0.0,3,0,0,0,0,0,4,0,Matches
117,Kingsley Coman,fr FRA,FW,de Bayern Munich,24,1996,6.0,7,2,3,1,3,3,7,42.9,4,6,0,6,2,9,3,0,Matches
118,Francisco Conceição,pt POR,"FW,MF",pt Porto,17,2002,0.1,1,0,0,1,0,1,1,100.0,0,0,0,0,0,1,0,0,Matches
119,Dion Cools,my MAS,DF,dk Midtjylland,24,1996,2.3,4,2,2,2,0,0,2,0.0,2,1,0,1,6,10,6,0,Matches
120,Vedran Ćorluka,hr CRO,DF,ru Loko Moscow,34,1986,4.5,10,7,9,1,0,7,10,70.0,3,7,7,0,11,21,25,0,Matches
121,Jesús Corona,mx MEX,"MF,FW",pt Porto,27,1993,8.4,10,2,9,1,0,6,17,35.3,11,11,0,11,13,23,9,1,Matches
122,Ángel Correa,ar ARG,"MF,FW",es Atlético Madrid,25,1995,5.4,3,1,1,2,0,2,12,16.7,10,5,0,5,0,3,8,0,Matches
123,Joaquín Correa,ar ARG,FW,it Lazio,25,1994,7.4,4,4,2,2,0,1,9,11.1,8,3,1,2,1,5,4,0,Matches
124,Diogo Costa,pt POR,GK,pt Porto,20,1999,1.0,0,0,0,0,0,0,0,,0,0,0,0,0,0,0,0,Matches
125,Douglas Costa,br BRA,"FW,MF",de Bayern Munich,29,1990,2.6,1,1,0,0,1,1,1,100.0,0,1,0,1,1,2,0,0,Matches
126,Thibaut Courtois,be BEL,GK,es Real Madrid,28,1992,12.0,0,0,0,0,0,0,1,0.0,1,0,0,0,0,0,4,0,Matches
127,Philippe Coutinho,br BRA,"FW,MF",es Barcelona,28,1992,1.5,0,0,0,0,0,0,1,0.0,1,2,1,1,1,1,0,0,Matches
128,Enzo Crivelli,fr FRA,FW,tr Başakşehir,25,1995,2.7,0,0,0,0,0,0,3,0.0,3,2,0,2,0,0,0,0,Matches
129,Juan Cuadrado,co COL,DF,it Juventus,32,1988,6.1,12,8,6,6,0,8,18,44.4,10,4,1,3,5,17,4,0,Matches
130,Mickaël Cuisance,fr FRA,"MF,FW",fr Marseille,20,1999,2.6,8,5,4,2,2,2,9,22.2,7,2,0,2,2,10,0,0,Matches
131,Szymon Czyż,pl POL,MF,it Lazio,19,2001,0.3,3,3,1,0,2,1,2,50.0,1,0,0,0,0,3,0,0,Matches
132,Danilo D'Ambrosio,it ITA,DF,it Inter,31,1988,3.4,8,3,1,3,4,0,5,0.0,5,0,0,0,7,15,4,0,Matches
133,Damien Da Silva,fr FRA,DF,fr Rennes,32,1988,5.8,3,2,3,0,0,2,4,50.0,2,5,4,1,8,11,25,0,Matches
134,Colin Dagba,fr FRA,DF,fr Paris S-G,21,1998,2.5,7,5,6,1,0,6,15,40.0,9,6,2,4,3,10,11,0,Matches
135,Mahmoud Dahoud,de GER,MF,de Dortmund,24,1996,5.4,13,10,7,5,1,4,15,26.7,11,10,1,9,5,18,5,0,Matches
136,Patson Daka,zm ZAM,FW,at RB Salzburg,21,1998,2.3,5,2,1,2,2,0,2,0.0,2,6,0,6,0,5,1,0,Matches
137,Danilo,br BRA,DF,it Juventus,29,1991,6.3,18,10,11,7,0,13,18,72.2,5,7,3,4,20,38,10,0,Matches
138,Matteo Darmian,it ITA,DF,it Inter,30,1989,1.9,2,2,2,0,0,2,6,33.3,4,3,0,3,2,4,2,0,Matches
139,Alphonso Davies,ca CAN,DF,de Bayern Munich,19,2000,3.6,8,3,3,5,0,5,10,50.0,5,7,1,6,6,14,5,0,Matches
140,Kevin De Bruyne,be BEL,"MF,FW",eng Manchester City,29,1991,7.4,9,3,1,4,4,4,20,20.0,16,12,2,10,2,11,2,0,Matches
141,Charles De Ketelaere,be BEL,"FW,DF",be Club Brugge,19,2001,5.1,11,8,4,4,3,5,11,45.5,6,16,1,15,3,14,3,0,Matches
142,Konrad De La Fuente,us USA,FW,es Barcelona,19,2001,0.2,0,0,0,0,0,0,0,,0,0,0,0,0,0,0,0,Matches
143,Romain Del Castillo,fr FRA,"FW,MF",fr Rennes,24,1996,1.5,5,3,1,2,2,2,4,50.0,2,1,0,1,3,8,0,0,Matches
144,Thomas Delaney,dk DEN,"MF,DF",de Dortmund,28,1991,4.8,11,8,3,6,2,3,5,60.0,2,5,0,5,4,15,8,0,Matches
145,Simon Deli,ci CIV,DF,be Club Brugge,28,1991,3.5,1,0,1,0,0,1,2,50.0,1,4,4,0,5,6,12,1,Matches
146,Moussa Dembélé,fr FRA,"FW,MF",es Atlético Madrid,24,1996,0.5,0,0,0,0,0,0,0,,0,1,0,1,0,0,1,0,Matches
147,Ousmane Dembélé,fr FRA,FW,es Barcelona,23,1997,4.2,4,1,2,2,0,2,11,18.2,9,2,0,2,2,6,1,0,Matches
148,Merih Demiral,tr TUR,DF,it Juventus,22,1998,4.4,5,3,3,2,0,2,3,66.7,1,2,1,1,9,14,12,1,Matches
149,Emmanuel Dennis,ng NGA,"FW,MF",be Club Brugge,22,1997,3.8,3,1,2,1,0,0,2,0.0,2,4,0,4,1,4,0,0,Matches
150,Dentinho,br BRA,FW,ua Shakhtar,31,1989,1.8,1,0,1,0,0,1,2,50.0,1,7,0,7,2,3,1,0,Matches
151,Fabio Depaoli,it ITA,DF,it Atalanta,23,1997,0.1,0,0,0,0,0,0,0,,0,0,0,0,0,0,1,0,Matches
152,Sergiño Dest,us USA,DF,es Barcelona,19,2000,6.5,9,7,3,5,1,5,10,50.0,5,6,1,5,2,11,7,0,Matches
153,Ángel Di María,ar ARG,"FW,MF",fr Paris S-G,32,1988,7.7,15,10,5,8,2,7,23,30.4,16,9,1,8,8,23,2,0,Matches
154,Abdou Diallo,sn SEN,DF,fr Paris S-G,24,1996,5.6,12,9,10,2,0,8,11,72.7,3,5,3,2,5,17,14,0,Matches
155,Amad Diallo,ci CIV,FW,it Atalanta,18,2002,0.3,0,0,0,0,0,0,0,,0,0,0,0,0,0,0,0,Matches
156,Rúben Dias,pt POR,DF,eng Manchester City,23,1997,10.8,14,8,5,7,2,5,8,62.5,3,12,8,4,16,30,23,0,Matches
157,Krépin Diatta,sn SEN,"MF,FW",be Club Brugge,21,1999,4.6,10,5,5,5,0,2,4,50.0,2,2,0,2,5,15,1,0,Matches
158,Luis Díaz,co COL,"FW,MF",pt Porto,23,1997,5.0,8,3,4,4,0,3,8,37.5,5,2,0,2,2,10,2,0,Matches
159,Dénes Dibusz,hu HUN,GK,hu Ferencváros,29,1990,6.0,1,1,1,0,0,1,1,100.0,0,0,0,0,0,1,1,2,Matches
160,Berat Djimsiti,al ALB,DF,it Atalanta,27,1993,8.0,11,4,8,3,0,2,10,20.0,8,7,6,1,24,35,34,0,Matches
161,Dodô,br BRA,DF,ua Shakhtar,21,1998,6.0,6,4,4,1,1,3,10,30.0,7,5,1,4,12,18,13,0,Matches
162,Jeremy Doku,be BEL,"FW,MF",fr Rennes,18,2002,4.5,4,3,2,2,0,0,2,0.0,2,0,0,0,2,6,1,0,Matches
163,Tommy Doyle,eng ENG,MF,eng Manchester City,18,2001,0.1,0,0,0,0,0,0,0,,0,1,0,1,0,0,0,0,Matches
164,Mohamed Dräger,tn TUN,DF,gr Olympiacos,24,1996,0.7,3,2,1,1,1,1,1,100.0,0,2,0,2,0,3,6,0,Matches
165,Radu Drăgușin,ro ROU,DF,it Juventus,18,2002,0.2,0,0,0,0,0,0,0,,0,0,0,0,0,0,1,0,Matches
166,Julian Draxler,de GER,"FW,MF",fr Paris S-G,26,1993,3.0,0,0,0,0,0,0,4,0.0,4,4,0,4,7,7,2,0,Matches
167,Anders Dreyer,dk DEN,"FW,MF",dk Midtjylland,22,1998,5.5,1,1,0,0,1,1,8,12.5,7,6,0,6,4,5,1,0,Matches
168,Sebastián Driussi,ar ARG,"MF,FW",ru Zenit,24,1996,3.1,7,3,5,2,0,4,14,28.6,10,2,0,2,3,10,2,0,Matches
169,Hugo Duro,es ESP,FW,es Real Madrid,20,1999,0.2,1,1,0,0,1,1,1,100.0,0,0,0,0,0,1,0,0,Matches
170,Lasha Dvali,ge GEO,DF,hu Ferencváros,25,1995,4.1,3,2,2,1,0,2,4,50.0,2,2,0,2,12,15,10,0,Matches
171,Paulo Dybala,ar ARG,"FW,MF",it Juventus,26,1993,2.4,1,0,0,1,0,0,8,0.0,8,1,0,1,1,2,1,0,Matches
172,Artem Dzyuba,ru RUS,FW,ru Zenit,31,1988,3.8,0,0,0,0,0,0,3,0.0,3,1,1,0,0,0,2,0,Matches
173,Éder,pt POR,FW,ru Loko Moscow,32,1987,2.8,0,0,0,0,0,0,1,0.0,1,3,0,3,0,0,0,0,Matches
174,Ederson,br BRA,GK,eng Manchester City,26,1993,12.0,0,0,0,0,0,0,1,0.0,1,0,0,0,0,0,5,1,Matches
175,Jurgen Ekkelenkamp,nl NED,MF,nl Ajax,20,2000,1.0,1,0,0,0,1,0,2,0.0,2,2,0,2,2,3,0,0,Matches
176,Nico Elvedi,ch SUI,DF,de Gladbach,23,1996,6.9,15,6,13,2,0,5,5,100.0,0,13,7,6,11,26,32,0,Matches
177,Breel Embolo,ch SUI,"FW,MF",de Gladbach,23,1997,3.3,3,1,0,2,1,0,5,0.0,5,2,0,2,2,5,0,0,Matches
178,Youssef En-Nesyri,ma MAR,FW,es Sevilla,23,1997,4.3,1,0,0,1,0,0,1,0.0,1,1,0,1,2,3,7,0,Matches
179,Alexandru Epureanu,md MDA,DF,tr Başakşehir,33,1986,4.5,2,2,0,2,0,2,5,40.0,3,6,5,1,10,12,21,1,Matches
180,Christian Eriksen,dk DEN,"MF,FW",it Inter,28,1992,1.1,0,0,0,0,0,0,1,0.0,1,0,0,0,3,3,0,0,Matches
181,Aleksandr Erokhin,ru RUS,"MF,FW",ru Zenit,30,1989,3.0,6,3,0,4,2,1,4,25.0,3,3,0,3,4,10,2,0,Matches
182,Gonzalo Escalante,ar ARG,MF,it Lazio,27,1993,1.6,2,1,2,0,0,2,6,33.3,4,2,0,2,4,6,0,0,Matches
183,Sergio Escudero,es ESP,DF,es Sevilla,30,1989,2.0,1,0,1,0,0,0,1,0.0,1,2,0,2,2,3,1,0,Matches
184,Evander,br BRA,"MF,FW",dk Midtjylland,22,1998,1.7,1,1,0,0,1,0,0,,0,1,0,1,1,2,0,0,Matches
185,Evanilson,br BRA,"FW,DF",pt Porto,20,1999,0.9,0,0,0,0,0,0,1,0.0,1,1,0,1,0,0,2,0,Matches
186,Fabinho,br BRA,"DF,MF",eng Liverpool,26,1993,6.2,19,13,11,7,1,10,14,71.4,4,10,3,7,13,32,28,0,Matches
187,Mohamed Fares,dz ALG,DF,it Lazio,24,1996,3.8,9,4,5,3,1,5,11,45.5,6,4,0,4,8,17,11,0,Matches
188,Ansu Fati,es ESP,FW,es Barcelona,17,2002,1.8,1,1,0,0,1,0,3,0.0,3,3,1,2,1,2,2,0,Matches
189,Felipe,br BRA,DF,es Atlético Madrid,31,1989,4.3,10,6,6,3,1,6,9,66.7,3,6,4,2,7,17,27,0,Matches
190,Luiz Felipe,it ITA,DF,it Lazio,23,1997,2.0,4,3,2,2,0,3,3,100.0,0,5,2,3,4,8,8,0,Matches
191,João Félix,pt POR,"FW,MF",es Atlético Madrid,20,1999,7.8,6,5,1,3,2,3,8,37.5,5,2,0,2,4,10,3,0,Matches
192,Bruno Fernandes,pt POR,MF,eng Manchester Utd,25,1994,4.9,9,6,2,4,3,1,11,9.1,10,5,0,5,4,13,2,0,Matches
193,Matheus Fernandes,br BRA,MF,es Barcelona,22,1998,0.2,0,0,0,0,0,0,0,,0,0,0,0,0,0,0,0,Matches
194,Carlos Fernández,es ESP,FW,es Sevilla,24,1996,0.1,0,0,0,0,0,0,1,0.0,1,0,0,0,0,0,0,0,Matches
195,Fernandinho,br BRA,MF,eng Manchester City,35,1985,3.8,9,2,0,6,3,4,9,44.4,5,7,1,6,7,16,4,1,Matches
196,Fernando,br BRA,"MF,DF",es Sevilla,33,1987,5.5,8,3,4,4,0,3,10,30.0,7,6,1,5,10,18,7,0,Matches
197,Fernando,br BRA,FW,ua Shakhtar,21,1999,0.4,0,0,0,0,0,0,1,0.0,1,2,0,2,0,0,1,0,Matches
198,Roberto Firmino,br BRA,"FW,MF",eng Liverpool,28,1991,3.7,3,2,3,0,0,1,4,25.0,3,5,0,5,2,5,4,0,Matches
199,Junior Firpo,do DOM,DF,es Barcelona,23,1996,2.9,7,4,2,3,2,2,3,66.7,1,5,2,3,2,9,3,1,Matches
200,Alessandro Florenzi,it ITA,DF,fr Paris S-G,29,1991,9.0,11,6,8,3,0,2,14,14.3,12,7,3,4,10,21,17,0,Matches
201,Phil Foden,eng ENG,"FW,MF",eng Manchester City,20,2000,11.8,16,10,5,5,6,7,15,46.7,8,13,1,12,9,25,3,1,Matches
202,Emil Forsberg,se SWE,"MF,FW",de RB Leipzig,28,1991,5.1,2,1,1,0,1,0,2,0.0,2,0,0,0,1,3,0,0,Matches
203,Kostas Fortounis,gr GRE,"FW,MF",gr Olympiacos,27,1992,3.2,3,3,0,3,0,2,6,33.3,4,1,0,1,2,5,0,0,Matches
204,Timothy Fosu-Mensah,nl NED,DF,eng Manchester Utd,22,1998,0.3,2,1,0,2,0,1,1,100.0,0,1,0,1,2,4,0,0,Matches
205,Gianluca Frabotta,it ITA,DF,it Juventus,21,1999,0.2,0,0,0,0,0,0,0,,0,0,0,0,0,0,0,0,Matches
206,Lassina Franck Traoré,bf BFA,FW,nl Ajax,19,2001,2.2,0,0,0,0,0,0,0,,0,3,0,3,1,1,5,0,Matches
207,Fred,br BRA,MF,eng Manchester Utd,27,1993,3.8,12,3,4,7,1,6,13,46.2,7,9,0,9,7,19,4,0,Matches
208,Remo Freuler,ch SUI,MF,it Atalanta,28,1992,5.8,19,8,6,10,3,8,19,42.1,11,7,1,6,11,30,6,0,Matches
209,Abraham Frimpong,gh GHA,DF,hu Ferencváros,27,1993,2.0,4,2,3,1,0,1,3,33.3,2,6,3,3,4,8,4,1,Matches
210,Roberto Gagliardini,it ITA,MF,it Inter,26,1994,2.8,6,1,2,3,1,1,4,25.0,3,1,0,1,5,11,3,0,Matches
211,Idrissa Gana Gueye,sn SEN,MF,fr Paris S-G,30,1989,5.4,18,10,9,7,2,3,9,33.3,6,14,2,12,5,23,9,0,Matches
212,Eric García,es ESP,DF,eng Manchester City,19,2001,2.3,2,1,1,1,0,1,2,50.0,1,0,0,0,3,5,5,0,Matches
213,Yuri Gazinskiy,ru RUS,MF,ru Krasnodar,31,1989,4.2,7,1,2,5,0,5,12,41.7,7,5,1,4,13,20,4,0,Matches
214,Yann Gboho,fr FRA,MF,fr Rennes,19,2001,1.1,2,1,2,0,0,1,1,100.0,0,1,0,1,1,3,0,0,Matches
215,David de Gea,es ESP,GK,eng Manchester Utd,29,1990,5.0,0,0,0,0,0,0,0,,0,0,0,0,0,0,3,0,Matches
216,Valère Germain,fr FRA,"FW,MF",fr Marseille,30,1990,2.2,2,0,1,0,1,0,3,0.0,3,0,0,0,1,3,1,0,Matches
217,Billy Gilmour,sct SCO,MF,eng Chelsea,19,2001,1.1,0,0,0,0,0,0,0,,0,0,0,0,2,2,1,0,Matches
218,Matthias Ginter,de GER,DF,de Gladbach,26,1994,8.0,3,3,2,1,0,2,4,50.0,2,9,7,2,5,8,27,0,Matches
219,Olivier Giroud,fr FRA,FW,eng Chelsea,33,1986,2.9,2,1,0,1,1,0,0,,0,3,0,3,2,4,2,0,Matches
220,Serge Gnabry,de GER,"FW,MF",de Bayern Munich,25,1995,4.0,4,1,2,2,0,2,7,28.6,5,5,0,5,6,10,2,0,Matches
221,Pierluigi Gollini,it ITA,GK,it Atalanta,25,1995,3.0,0,0,0,0,0,0,0,,0,0,0,0,0,0,3,0,Matches
222,Eulânio Ângelo Chipela Gomes,gw GNB,DF,pt Porto,26,1994,1.5,2,1,1,1,0,0,3,0.0,3,2,0,2,2,4,1,0,Matches
223,Joe Gomez,eng ENG,DF,eng Liverpool,23,1997,3.0,4,2,3,1,0,1,4,25.0,3,0,0,0,5,9,19,0,Matches
224,Papu Gómez,ar ARG,"MF,FW",it Atalanta,32,1988,5.0,2,2,0,1,1,1,8,12.5,7,5,2,3,2,4,0,0,Matches
225,Papu Gómez,ar ARG,"MF,FW",es Sevilla,32,1988,1.0,1,1,0,1,0,1,2,50.0,1,1,0,1,1,2,0,0,Matches
226,Sergi Gómez,es ESP,DF,es Sevilla,28,1992,2.2,1,0,1,0,0,1,1,100.0,0,4,3,1,1,2,6,0,Matches
227,Alfred Gomis,sn SEN,GK,fr Rennes,26,1993,4.0,0,0,0,0,0,0,0,,0,0,0,0,0,0,2,0,Matches
228,Álvaro González,es ESP,DF,fr Marseille,30,1990,6.0,8,7,5,3,0,5,10,50.0,5,5,2,3,7,15,13,0,Matches
229,Leon Goretzka,de GER,MF,de Bayern Munich,25,1995,4.8,6,5,1,5,0,2,10,20.0,8,10,1,9,13,19,5,0,Matches
230,Yevgeni Gorodov,ru RUS,GK,ru Krasnodar,34,1985,2.0,0,0,0,0,0,0,0,,0,0,0,0,0,0,0,0,Matches
231,Robin Gosens,de GER,DF,it Atalanta,26,1994,6.3,11,4,4,5,2,4,7,57.1,3,14,3,11,6,17,11,0,Matches
232,Ryan Gravenberch,nl NED,MF,nl Ajax,18,2002,5.9,15,4,3,8,4,3,8,37.5,5,7,0,7,11,26,4,0,Matches
233,Mason Greenwood,eng ENG,FW,eng Manchester Utd,18,2001,2.3,0,0,0,0,0,0,0,,0,1,0,1,1,1,0,0,Matches
234,Clément Grenier,fr FRA,MF,fr Rennes,29,1991,2.5,8,5,1,6,1,2,5,40.0,3,2,0,2,2,10,0,0,Matches
235,Antoine Griezmann,fr FRA,"FW,MF",es Barcelona,29,1991,5.6,8,1,3,5,0,4,6,66.7,2,4,0,4,5,13,3,0,Matches
236,Marko Grujić,rs SRB,MF,pt Porto,24,1996,4.3,11,2,6,2,3,6,13,46.2,7,8,3,5,5,16,8,0,Matches
237,Nemanja Gudelj,rs SRB,"MF,DF",es Sevilla,28,1991,5.5,7,3,4,3,0,1,3,33.3,2,7,5,2,4,11,5,1,Matches
238,Raphaël Guerreiro,pt POR,DF,de Dortmund,26,1993,7.4,7,4,4,3,0,4,6,66.7,2,3,0,3,5,12,6,0,Matches
239,Pape Gueye,sn SEN,MF,fr Marseille,21,1999,1.9,4,3,2,2,0,2,2,100.0,0,1,0,1,7,11,2,0,Matches
240,Serhou Guirassy,gn GUI,FW,fr Rennes,24,1996,3.8,1,0,1,0,0,1,2,50.0,1,2,0,2,1,2,2,0,Matches
241,Péter Gulácsi,hu HUN,GK,de RB Leipzig,30,1990,8.0,0,0,0,0,0,0,0,,0,0,0,0,0,0,4,0,Matches
242,Fredrik Gulbrandsen,no NOR,FW,tr Başakşehir,27,1992,2.3,1,1,0,0,1,1,3,33.3,2,1,0,1,0,1,2,0,Matches
243,İlkay Gündoğan,de GER,MF,eng Manchester City,29,1990,10.8,15,4,3,10,2,4,14,28.6,10,8,0,8,11,26,5,0,Matches
244,Mert Günok,tr TUR,GK,tr Başakşehir,31,1989,6.0,0,0,0,0,0,0,0,,0,0,0,0,0,0,7,1,Matches
245,Erling Haaland,no NOR,FW,de Dortmund,20,2000,7.8,1,0,1,0,0,1,3,33.3,2,3,1,2,3,4,10,0,Matches
246,Munir El Haddadi,ma MAR,"FW,MF",es Sevilla,24,1995,3.3,4,1,2,2,0,1,3,33.3,2,2,0,2,1,5,0,0,Matches
247,Amadou Haidara,ml MLI,"MF,DF",de RB Leipzig,22,1998,4.7,16,8,4,11,1,10,20,50.0,10,8,0,8,9,25,4,0,Matches
248,Achraf Hakimi,ma MAR,"DF,MF",it Inter,21,1998,4.0,8,4,3,3,2,3,10,30.0,7,6,1,5,7,15,2,1,Matches
249,Marcel Halstenberg,de GER,DF,de RB Leipzig,28,1991,2.0,2,1,1,1,0,1,3,33.3,2,0,0,0,3,5,6,0,Matches
250,Samir Handanović,si SVN,GK,it Inter,36,1984,6.0,0,0,0,0,0,0,1,0.0,1,1,0,1,0,0,2,0,Matches
251,Jesper Hansen,dk DEN,GK,dk Midtjylland,35,1985,4.0,0,0,0,0,0,0,0,,0,0,0,0,0,0,2,1,Matches
252,Denys Harmash,ua UKR,"MF,FW",ua Dynamo Kyiv,30,1990,1.7,9,4,4,5,0,5,9,55.6,4,5,1,4,2,11,6,0,Matches
253,Hans Hateboer,nl NED,DF,it Atalanta,26,1994,5.9,9,4,5,2,2,6,15,40.0,9,6,1,5,7,16,9,0,Matches
254,Kai Havertz,de GER,"MF,FW",eng Chelsea,21,1999,8.7,17,10,7,8,2,7,15,46.7,8,8,0,8,9,26,12,0,Matches
255,Eden Hazard,be BEL,FW,es Real Madrid,29,1991,3.0,0,0,0,0,0,0,0,,0,0,0,0,2,2,0,0,Matches
256,Thorgan Hazard,be BEL,"FW,MF",de Dortmund,27,1993,4.9,8,7,4,3,1,3,8,37.5,5,7,1,6,3,11,0,0,Matches
257,Hwang Hee-chan,kr KOR,FW,de RB Leipzig,24,1996,1.0,0,0,0,0,0,0,1,0.0,1,2,0,2,2,2,1,0,Matches
258,Marcel Heister,de GER,DF,hu Ferencváros,28,1992,4.3,9,6,8,1,0,4,9,44.4,5,3,2,1,6,15,5,0,Matches
259,Dean Henderson,eng ENG,GK,eng Manchester Utd,23,1997,1.0,0,0,0,0,0,0,0,,0,0,0,0,0,0,0,0,Matches
260,Jordan Henderson,eng ENG,"MF,DF",eng Liverpool,30,1990,4.0,1,1,1,0,0,1,5,20.0,4,5,2,3,7,8,8,0,Matches
261,Benjamin Henrichs,de GER,"DF,FW",de RB Leipzig,23,1997,1.3,9,3,3,5,1,2,4,50.0,2,1,0,1,2,11,2,0,Matches
262,Dalbert Henrique,br BRA,"DF,FW",fr Rennes,26,1993,2.5,2,1,1,1,0,2,5,40.0,3,2,1,1,2,4,2,0,Matches
263,Luis Henrique,br BRA,"FW,MF",fr Marseille,18,2001,1.1,1,1,0,1,0,1,2,50.0,1,1,0,1,1,2,0,0,Matches
264,Mario Hermoso,es ESP,DF,es Atlético Madrid,25,1995,3.9,11,7,6,5,0,6,11,54.5,5,7,2,5,7,18,12,1,Matches
265,Lucas Hernández,fr FRA,DF,de Bayern Munich,24,1996,7.7,24,16,14,7,3,8,15,53.3,7,10,2,8,5,29,17,0,Matches
266,Ander Herrera,es ESP,MF,fr Paris S-G,30,1989,6.0,20,12,5,13,2,6,21,28.6,15,25,7,18,13,33,11,0,Matches
267,Héctor Herrera,mx MEX,MF,es Atlético Madrid,30,1990,3.3,5,3,2,3,0,4,6,66.7,2,7,4,3,6,11,3,0,Matches
268,Patrick Herrmann,de GER,"FW,MF",de Gladbach,29,1991,0.7,0,0,0,0,0,0,2,0.0,2,3,0,3,1,1,2,0,Matches
269,Marwin Hitz,ch SUI,GK,de Dortmund,32,1987,6.0,1,0,1,0,0,0,0,,0,0,0,0,0,1,6,0,Matches
270,Wesley Hoedt,nl NED,DF,it Lazio,26,1994,5.4,14,8,14,0,0,10,13,76.9,3,4,0,4,7,21,31,1,Matches
271,Jonas Hofmann,de GER,FW,de Gladbach,28,1992,4.8,6,2,3,1,2,5,21,23.8,16,4,0,4,2,8,4,0,Matches
272,José Holebas,gr GRE,DF,gr Olympiacos,36,1984,4.8,8,5,5,1,2,5,9,55.6,4,3,0,3,11,19,11,0,Matches
273,Ethan Horvath,us USA,GK,be Club Brugge,25,1995,1.0,0,0,0,0,0,0,0,,0,0,0,0,0,0,1,0,Matches
274,Callum Hudson-Odoi,eng ENG,"FW,DF",eng Chelsea,19,2000,3.8,5,4,2,1,2,1,3,33.3,2,3,0,3,4,9,3,0,Matches
275,Mats Hummels,de GER,DF,de Dortmund,31,1988,8.8,12,5,10,2,0,7,12,58.3,5,17,10,7,19,31,46,1,Matches
276,Adrien Hunou,fr FRA,"FW,MF",fr Rennes,26,1994,1.0,0,0,0,0,0,0,1,0.0,1,0,0,0,0,0,0,0,Matches
277,Klaas-Jan Huntelaar,nl NED,FW,nl Ajax,36,1983,0.4,0,0,0,0,0,0,0,,0,0,0,0,0,0,0,0,Matches
278,Daniel Høegh,dk DEN,DF,dk Midtjylland,29,1991,1.0,2,2,1,1,0,0,0,,0,3,2,1,4,6,10,0,Matches
279,Mauro Icardi,ar ARG,FW,fr Paris S-G,27,1993,2.7,3,0,1,2,0,0,1,0.0,1,2,1,1,3,6,3,0,Matches
280,Oussama Idrissi,ma MAR,"FW,DF",es Sevilla,24,1996,1.7,6,4,0,4,2,2,9,22.2,7,1,1,0,0,6,3,0,Matches
281,Odion Ighalo,ng NGA,DF,eng Manchester Utd,31,1989,0.0,0,0,0,0,0,0,0,,0,0,0,0,0,0,0,0,Matches
282,Vladislav Ignatyev,ru RUS,"MF,FW",ru Loko Moscow,33,1987,4.3,12,5,9,1,2,4,20,20.0,16,9,2,7,7,19,13,0,Matches
283,Josip Iličić,si SVN,"FW,MF",it Atalanta,32,1988,3.1,5,2,3,0,2,4,8,50.0,4,1,0,1,1,6,1,0,Matches
284,Ciro Immobile,it ITA,FW,it Lazio,30,1990,4.6,2,1,0,2,0,0,4,0.0,4,3,0,3,1,3,0,0,Matches
285,Nikita Iosifov,ru RUS,MF,ru Loko Moscow,19,2001,0.2,0,0,0,0,0,0,0,,0,0,0,0,0,0,0,0,Matches
286,Isael,br BRA,"FW,MF",hu Ferencváros,32,1988,4.0,5,3,2,2,1,0,3,0.0,3,2,0,2,5,10,2,0,Matches
287,Gustav Isaksen,dk DEN,"MF,FW",dk Midtjylland,19,2001,0.5,0,0,0,0,0,0,0,,0,3,0,3,2,2,0,0,Matches
288,Isco,es ESP,"FW,MF",es Real Madrid,28,1992,1.1,2,0,1,1,0,2,4,50.0,2,2,0,2,3,5,1,0,Matches
289,Daniel James,wls WAL,FW,eng Manchester Utd,22,1997,0.4,0,0,0,0,0,0,1,0.0,1,1,0,1,0,0,0,0,Matches
290,Manjrekar James,ca CAN,DF,dk Midtjylland,26,1993,1.0,5,4,4,1,0,3,5,60.0,2,5,1,4,3,8,3,0,Matches
291,Reece James,eng ENG,DF,eng Chelsea,20,1999,6.3,22,15,16,5,1,11,19,57.9,8,11,3,8,4,26,24,0,Matches
292,Tony Jantschke,de GER,DF,de Gladbach,30,1990,0.6,0,0,0,0,0,0,1,0.0,1,2,2,0,2,2,1,0,Matches
293,Gabriel Jesus,br BRA,FW,eng Manchester City,23,1997,3.0,3,0,0,1,2,0,3,0.0,3,6,0,6,2,5,0,0,Matches
294,Curtis Jones,eng ENG,MF,eng Liverpool,19,2001,4.5,6,3,3,3,0,2,4,50.0,2,6,1,5,7,13,4,0,Matches
295,Frenkie de Jong,nl NED,"MF,DF",es Barcelona,23,1997,6.5,8,5,3,3,2,3,9,33.3,6,4,1,3,15,23,7,0,Matches
296,Luuk de Jong,nl NED,FW,es Sevilla,29,1990,4.2,3,1,1,1,1,2,4,50.0,2,3,0,3,1,4,1,0,Matches
297,Joan Jordán,es ESP,MF,es Sevilla,26,1994,4.5,11,7,3,4,4,7,15,46.7,8,1,0,1,6,17,3,0,Matches
298,Jorginho,it ITA,MF,eng Chelsea,28,1991,11.4,26,17,8,14,4,13,35,37.1,22,18,5,13,26,52,14,0,Matches
299,Diogo Jota,pt POR,FW,eng Liverpool,23,1996,6.0,6,2,3,3,0,1,8,12.5,7,7,1,6,2,8,2,0,Matches
300,Luka Jović,rs SRB,FW,es Real Madrid,22,1997,0.6,1,0,0,0,1,0,0,,0,0,0,0,0,1,0,0,Matches
301,Vinicius Júnior,br BRA,FW,es Real Madrid,20,2000,7.0,11,8,4,4,3,4,11,36.4,7,10,1,9,1,12,3,0,Matches
302,Zlatko Junuzović,at AUT,MF,at RB Salzburg,32,1987,5.1,15,9,4,10,1,7,15,46.7,8,10,2,8,13,28,3,0,Matches
303,Sory Kaba,gn GUI,FW,dk Midtjylland,25,1995,5.1,6,3,1,2,3,3,4,75.0,1,4,0,4,3,9,5,0,Matches
304,Ozan Kabak,tr TUR,DF,eng Liverpool,20,2000,3.5,6,3,5,1,0,1,2,50.0,1,10,5,5,6,12,6,1,Matches
305,İrfan Kahveci,tr TUR,MF,tr Başakşehir,25,1995,5.4,8,3,3,4,1,5,9,55.6,4,7,2,5,3,11,0,0,Matches
306,François Kamano,gn GUI,MF,ru Loko Moscow,24,1996,2.0,6,3,4,0,2,5,11,45.5,6,1,0,1,0,6,2,0,Matches
307,Boubacar Kamara,fr FRA,MF,fr Marseille,20,1999,4.3,9,5,5,3,1,5,10,50.0,5,3,1,2,8,17,6,1,Matches
308,Ruslan Kambolov,ru RUS,MF,ru Krasnodar,30,1990,0.2,0,0,0,0,0,0,0,,0,1,0,1,0,0,4,0,Matches
309,Kevin Kampl,si SVN,MF,de RB Leipzig,29,1990,4.1,7,4,4,2,1,3,11,27.3,8,5,0,5,6,13,6,0,Matches
310,N'Golo Kanté,fr FRA,MF,eng Chelsea,29,1991,7.9,10,8,8,1,1,3,8,37.5,5,13,3,10,14,24,13,0,Matches
311,Emre Kaplan,tr TUR,DF,tr Başakşehir,19,2001,0.1,1,1,1,0,0,1,2,50.0,1,0,0,0,1,2,0,0,Matches
312,Oleksandr Karavayev,ua UKR,DF,ua Dynamo Kyiv,28,1992,2.5,0,0,0,0,0,0,0,,0,2,0,2,4,4,6,0,Matches
313,Vyacheslav Karavayev,ru RUS,DF,ru Zenit,25,1995,3.1,5,4,4,1,0,5,7,71.4,2,2,0,2,3,8,7,0,Matches
314,Moise Kean,it ITA,FW,fr Paris S-G,20,2000,4.9,2,1,1,1,0,1,3,33.3,2,4,0,4,3,5,4,0,Matches
315,Tomasz Kędziora,pl POL,DF,ua Dynamo Kyiv,26,1994,6.0,8,7,4,4,0,6,11,54.5,5,6,0,6,14,22,19,0,Matches
316,Thilo Kehrer,de GER,"DF,FW",fr Paris S-G,23,1996,0.8,1,1,1,0,0,1,2,50.0,1,1,1,0,2,3,1,0,Matches
317,Naby Keïta,gn GUI,MF,eng Liverpool,25,1995,1.6,2,2,1,1,0,0,3,0.0,3,3,0,3,4,6,2,0,Matches
318,Caoimhín Kelleher,ie IRL,GK,eng Liverpool,21,1998,2.0,0,0,0,0,0,0,0,,0,0,0,0,0,0,0,0,Matches
319,Mikhail Kerzhakov,ru RUS,GK,ru Zenit,33,1987,6.0,0,0,0,0,0,0,0,,0,0,0,0,0,0,2,0,Matches
320,Ihor Kharatin,ua UKR,MF,hu Ferencváros,25,1995,3.6,7,5,6,0,1,4,7,57.1,3,6,3,3,5,12,2,0,Matches
321,Davit Khocholava,ge GEO,DF,ua Shakhtar,27,1993,3.3,1,1,1,0,0,1,4,25.0,3,4,3,1,7,8,21,0,Matches
322,Joshua Kimmich,de GER,MF,de Bayern Munich,25,1995,6.8,13,4,7,5,1,2,20,10.0,18,6,1,5,12,25,8,1,Matches
323,Presnel Kimpembe,fr FRA,DF,fr Paris S-G,24,1995,10.9,13,7,9,4,0,2,8,25.0,6,9,4,5,5,18,41,1,Matches
324,Davy Klaassen,nl NED,MF,nl Ajax,27,1993,5.0,9,5,5,3,1,6,9,66.7,3,4,0,4,6,15,11,1,Matches
325,Sean Klaiber,sr SUR,DF,nl Ajax,26,1994,0.6,2,1,0,0,2,1,1,100.0,0,1,0,1,2,4,1,0,Matches
326,Lukas Klostermann,de GER,DF,de RB Leipzig,24,1996,2.0,2,2,1,1,0,1,3,33.3,2,0,0,0,4,6,9,0,Matches
327,Justin Kluivert,nl NED,"MF,FW",de RB Leipzig,21,1999,1.7,2,1,1,0,1,0,4,0.0,4,2,0,2,2,4,0,0,Matches
328,Ansgar Knauff,de GER,FW,de Dortmund,18,2002,1.5,5,1,1,4,0,4,6,66.7,2,1,0,1,1,6,3,0,Matches
329,Sekou Koita,ml MLI,FW,at RB Salzburg,20,1999,4.5,1,1,0,1,0,0,3,0.0,3,10,1,9,2,3,2,0,Matches
330,Koka,eg EGY,FW,gr Olympiacos,27,1993,0.3,0,0,0,0,0,0,1,0.0,1,0,0,0,0,0,0,0,Matches
331,Koke,es ESP,MF,es Atlético Madrid,28,1992,7.4,16,10,6,5,5,10,30,33.3,20,9,3,6,11,27,4,0,Matches
332,Aleksandar Kolarov,rs SRB,DF,it Inter,34,1985,1.0,0,0,0,0,0,0,0,,0,2,2,0,1,1,1,0,Matches
333,Ibrahima Konaté,fr FRA,DF,de RB Leipzig,21,1999,5.3,10,3,6,4,0,3,7,42.9,4,7,5,2,7,17,12,0,Matches
334,Viktor Korniienko,ua UKR,DF,ua Shakhtar,21,1999,3.0,0,0,0,0,0,0,1,0.0,1,3,2,1,4,4,7,0,Matches
335,Odilon Kossounou,ci CIV,DF,be Club Brugge,19,2001,5.0,9,5,7,2,0,4,7,57.1,3,10,5,5,9,18,6,0,Matches
336,Billy Koumetio,fr FRA,DF,eng Liverpool,17,2002,0.5,0,0,0,0,0,0,1,0.0,1,0,0,0,3,3,7,0,Matches
337,Jules Koundé,fr FRA,DF,es Sevilla,21,1998,5.7,3,1,2,1,0,3,3,100.0,0,7,4,3,6,9,13,0,Matches
338,Adnan Kovačević,ba BIH,DF,hu Ferencváros,26,1993,1.9,8,3,5,2,1,3,4,75.0,1,3,3,0,5,13,4,0,Matches
339,Mateo Kovačić,hr CRO,MF,eng Chelsea,26,1994,6.7,13,11,7,6,0,8,16,50.0,8,4,0,4,7,20,5,0,Matches
340,Viktor Kovalenko,ua UKR,MF,ua Shakhtar,24,1996,2.4,2,1,1,1,0,2,3,66.7,1,1,0,1,2,4,3,0,Matches
341,Bozhidar Kraev,bg BUL,"MF,FW",dk Midtjylland,23,1997,0.6,1,0,0,1,0,1,3,33.3,2,1,0,1,1,2,0,0,Matches
342,Christoph Kramer,de GER,MF,de Gladbach,29,1991,6.9,9,5,4,5,0,3,19,15.8,16,12,4,8,11,20,6,0,Matches
343,Rasmus Kristensen,dk DEN,DF,at RB Salzburg,23,1997,5.0,13,7,10,2,1,10,13,76.9,3,7,3,4,13,26,17,0,Matches
344,Michal Krmenčík,cz CZE,FW,be Club Brugge,27,1993,0.8,1,0,0,0,1,1,1,100.0,0,1,0,1,0,1,2,0,Matches
345,Toni Kroos,de GER,MF,es Real Madrid,30,1990,10.7,19,6,10,8,1,9,26,34.6,17,11,2,9,19,38,3,0,Matches
346,Danil Krugovoy,ru RUS,"DF,MF",ru Zenit,22,1998,1.8,0,0,0,0,0,0,4,0.0,4,2,0,2,4,4,3,0,Matches
347,Grzegorz Krychowiak,pl POL,MF,ru Loko Moscow,30,1990,4.0,1,0,1,0,0,0,4,0.0,4,4,1,3,7,8,6,0,Matches
348,Serhiy Kryvtsov,ua UKR,DF,ua Shakhtar,29,1991,1.0,2,2,2,0,0,1,1,100.0,0,1,0,1,3,5,1,0,Matches
349,Mohammed Kudus,gh GHA,FW,nl Ajax,19,2000,0.1,0,0,0,0,0,0,0,,0,0,0,0,0,0,0,0,Matches
350,Daniil Kulikov,ru RUS,MF,ru Loko Moscow,22,1998,4.0,13,4,8,2,3,8,21,38.1,13,4,2,2,8,21,10,0,Matches
351,Dejan Kulusevski,se SWE,"FW,MF",it Juventus,20,2000,3.0,3,1,1,2,0,0,8,0.0,8,3,1,2,5,8,1,0,Matches
352,Layvin Kurzawa,fr FRA,DF,fr Paris S-G,27,1992,4.2,14,10,8,3,3,8,11,72.7,3,7,1,6,8,22,13,0,Matches
353,Daler Kuzyaev,ru RUS,"MF,FW",ru Zenit,27,1993,4.9,14,8,11,2,1,2,12,16.7,10,8,2,6,9,23,3,0,Matches
354,Zakaria Labyad,ma MAR,MF,nl Ajax,27,1993,2.0,0,0,0,0,0,0,2,0.0,2,2,0,2,1,1,0,0,Matches
355,Aïssa Laïdouni,tn TUN,MF,hu Ferencváros,23,1996,2.5,6,4,3,2,1,1,4,25.0,3,4,0,4,5,11,1,0,Matches
356,Stefan Lainer,at AUT,DF,de Gladbach,27,1992,7.6,21,12,8,8,5,13,19,68.4,6,16,3,13,11,32,25,0,Matches
357,Sam Lammers,nl NED,FW,it Atalanta,23,1997,0.1,0,0,0,0,0,0,0,,0,0,0,0,0,0,0,0,Matches
358,Michael Lang,ch SUI,DF,de Gladbach,29,1991,0.1,0,0,0,0,0,0,0,,0,0,0,0,1,1,0,0,Matches
359,Noa Lang,nl NED,"MF,FW",be Club Brugge,21,1999,3.3,4,4,0,3,1,1,2,50.0,1,0,0,0,1,5,2,0,Matches
360,Aymeric Laporte,es ESP,DF,eng Manchester City,26,1994,3.1,2,1,1,1,0,1,2,50.0,1,1,1,0,4,6,9,0,Matches
361,Valentino Lazaro,at AUT,"FW,DF",de Gladbach,24,1996,2.7,7,3,5,2,0,5,6,83.3,1,5,1,4,2,9,2,0,Matches
362,Manuel Lazzari,it ITA,DF,it Lazio,26,1993,3.6,4,2,0,3,1,1,5,20.0,4,2,0,2,2,6,2,0,Matches
363,James Lea Siliki,cm CMR,"MF,FW",fr Rennes,24,1996,2.4,4,2,2,2,0,1,5,20.0,4,3,0,3,1,5,3,0,Matches
364,Diogo Leite,pt POR,DF,pt Porto,21,1999,2.0,0,0,0,0,0,0,0,,0,4,2,2,2,2,15,0,Matches
365,Lucas Leiva,br BRA,MF,it Lazio,33,1987,3.9,6,4,5,1,0,3,11,27.3,8,3,0,3,10,16,7,0,Matches
366,Thomas Lemar,fr FRA,"DF,MF",es Atlético Madrid,24,1995,2.1,5,2,2,3,0,4,7,57.1,3,4,0,4,0,5,3,0,Matches
367,Clément Lenglet,fr FRA,DF,es Barcelona,25,1995,6.2,7,3,4,2,1,3,8,37.5,5,1,0,1,11,18,13,1,Matches
368,Robert Lewandowski,pl POL,FW,de Bayern Munich,31,1988,5.7,2,1,1,0,1,1,2,50.0,1,6,1,5,2,4,4,0,Matches
369,Bohdan Liedniev,ua UKR,MF,ua Dynamo Kyiv,22,1998,0.4,0,0,0,0,0,0,0,,0,3,0,3,0,0,0,0,Matches
370,Matthijs de Ligt,nl NED,DF,it Juventus,20,1999,4.5,9,6,5,3,1,3,3,100.0,0,8,6,2,7,16,10,0,Matches
371,Victor Lindelöf,se SWE,DF,eng Manchester Utd,26,1994,4.4,4,2,2,2,0,3,4,75.0,1,6,4,2,3,7,11,0,Matches
372,Vitaly Lisakovich,by BLR,"MF,FW",ru Loko Moscow,22,1998,0.8,0,0,0,0,0,0,0,,0,0,0,0,0,0,1,0,Matches
373,Marcos Llorente,es ESP,"MF,DF",es Atlético Madrid,25,1995,7.3,16,9,8,6,2,12,21,57.1,9,6,0,6,11,27,11,0,Matches
374,Renan Lodi,br BRA,DF,es Atlético Madrid,22,1998,4.2,11,8,6,3,2,3,5,60.0,2,8,0,8,8,19,9,0,Matches
375,Mamadou Loum,sn SEN,MF,pt Porto,23,1996,0.1,1,1,1,0,0,0,0,,0,0,0,0,0,1,1,0,Matches
376,Dejan Lovren,hr CRO,DF,ru Zenit,31,1989,4.3,1,0,1,0,0,1,6,16.7,5,7,1,6,11,12,23,0,Matches
377,Gergő Lovrencsics,hu HUN,DF,hu Ferencváros,31,1988,4.1,11,6,8,1,2,7,15,46.7,8,9,0,9,7,18,8,1,Matches
378,José Luis Palomino,ar ARG,DF,it Atalanta,30,1990,2.3,4,3,2,1,1,0,2,0.0,2,3,2,1,6,10,4,0,Matches
379,Zé Luís,cv CPV,FW,ru Loko Moscow,29,1991,4.2,3,0,2,0,1,2,6,33.3,4,5,0,5,1,4,7,0,Matches
380,Romelu Lukaku,be BEL,FW,it Inter,27,1993,4.9,0,0,0,0,0,0,1,0.0,1,3,0,3,0,0,5,0,Matches
381,Senad Lulić,ba BIH,DF,it Lazio,34,1986,1.2,3,1,1,2,0,1,6,16.7,5,1,0,1,3,6,0,0,Matches
382,Vitali Lystsov,ru RUS,DF,ru Loko Moscow,25,1995,0.5,3,0,3,0,0,0,2,0.0,2,1,0,1,0,3,4,0,Matches
383,Yann M'Vila,fr FRA,MF,gr Olympiacos,30,1990,5.9,7,3,2,5,0,5,13,38.5,8,7,1,6,12,19,8,0,Matches
384,Awer Mabil,au AUS,"FW,MF",dk Midtjylland,24,1995,5.0,5,3,3,1,1,2,10,20.0,8,3,0,3,4,9,2,0,Matches
385,Nicolas Madsen,dk DEN,"MF,FW",dk Midtjylland,20,2000,1.0,1,1,0,1,0,1,2,50.0,1,2,1,1,4,5,4,0,Matches
386,Stanislav Magkeev,ru RUS,MF,ru Loko Moscow,21,1999,2.2,4,2,3,1,0,2,5,40.0,3,1,0,1,7,11,4,0,Matches
387,Harry Maguire,eng ENG,DF,eng Manchester Utd,27,1993,5.0,4,3,2,1,1,3,6,50.0,3,7,4,3,5,9,15,0,Matches
388,Riyad Mahrez,dz ALG,"FW,MF",eng Manchester City,29,1991,9.0,13,7,0,7,6,5,15,33.3,10,11,2,9,6,19,3,0,Matches
389,Róbert Mak,sk SVK,"MF,FW",hu Ferencváros,29,1991,1.0,1,0,1,0,0,0,0,,0,1,0,1,1,2,0,0,Matches
390,Malcom,br BRA,"FW,MF",ru Zenit,23,1997,2.7,1,1,0,0,1,0,3,0.0,3,2,0,2,1,2,0,0,Matches
391,Ruslan Malinovskyi,ua UKR,MF,it Atalanta,27,1993,1.5,3,3,1,2,0,2,6,33.3,4,3,0,3,3,6,0,0,Matches
392,Wilson Manafá,pt POR,DF,pt Porto,26,1994,8.3,15,10,10,4,1,4,12,33.3,8,9,3,6,7,22,21,0,Matches
393,Steve Mandanda,fr FRA,GK,fr Marseille,35,1985,6.0,0,0,0,0,0,0,0,,0,0,0,0,0,0,2,0,Matches
394,Sadio Mané,sn SEN,FW,eng Liverpool,28,1992,7.9,5,4,2,1,2,2,7,28.6,5,6,0,6,3,8,1,0,Matches
395,Faitout Maouassa,fr FRA,DF,fr Rennes,22,1998,0.9,3,1,2,1,0,1,2,50.0,1,2,0,2,0,3,2,0,Matches
396,Marcelo,br BRA,DF,es Real Madrid,32,1988,1.8,5,3,0,3,2,4,4,100.0,0,1,0,1,0,5,0,0,Matches
397,Agustín Marchesín,ar ARG,GK,pt Porto,32,1988,9.3,1,0,1,0,0,1,2,50.0,1,0,0,0,1,2,7,0,Matches
398,Moussa Marega,ml MLI,FW,pt Porto,29,1991,8.2,9,4,1,5,3,3,5,60.0,2,7,1,6,5,14,11,0,Matches
399,José María Giménez,uy URU,DF,es Atlético Madrid,25,1995,3.7,5,5,4,1,0,3,5,60.0,2,4,1,3,6,11,14,0,Matches
400,Mariano,do DOM,FW,es Real Madrid,26,1993,1.2,0,0,0,0,0,0,1,0.0,1,1,0,1,0,0,0,0,Matches
401,Guilherme Marinato,ru RUS,GK,ru Loko Moscow,34,1985,6.0,1,1,1,0,0,1,1,100.0,0,0,0,0,0,1,4,1,Matches
402,João Mário Lopes,pt POR,"FW,MF",pt Porto,20,2000,0.9,0,0,0,0,0,0,0,,0,0,0,0,2,2,0,0,Matches
403,Yevgeni Markov,ru RUS,FW,ru Krasnodar,26,1994,0.0,0,0,0,0,0,0,0,,0,0,0,0,0,0,0,0,Matches
404,Marlos,ua UKR,MF,ua Shakhtar,32,1988,4.7,6,3,3,3,0,5,12,41.7,7,1,1,0,2,8,3,1,Matches
405,Marquinhos,br BRA,"DF,MF",fr Paris S-G,26,1994,9.1,18,6,9,9,0,8,11,72.7,3,16,10,6,10,28,39,0,Matches
406,Anthony Martial,fr FRA,FW,eng Manchester Utd,24,1995,4.7,0,0,0,0,0,0,1,0.0,1,2,0,2,3,3,3,0,Matches
407,Jonas Martin,fr FRA,MF,fr Rennes,30,1990,1.0,2,0,1,1,0,1,2,50.0,1,2,0,2,1,3,0,0,Matches
408,Javi Martínez,es ESP,MF,de Bayern Munich,31,1988,2.1,2,1,1,1,0,0,2,0.0,2,3,1,2,11,13,5,0,Matches
409,Lautaro Martínez,ar ARG,FW,it Inter,22,1997,4.5,1,1,0,0,1,0,3,0.0,3,4,0,4,5,6,1,0,Matches
410,Lisandro Martínez,ar ARG,DF,nl Ajax,22,1998,3.3,7,5,6,1,0,5,10,50.0,5,2,2,0,8,15,20,1,Matches
411,Toni Martínez,es ESP,FW,pt Porto,23,1997,1.1,0,0,0,0,0,0,0,,0,2,0,2,1,1,7,0,Matches
412,Alyaksandr Martynovich,by BLR,DF,ru Krasnodar,32,1987,5.0,3,1,1,0,2,1,3,33.3,2,6,4,2,9,12,26,0,Matches
413,Adam Marušić,me MNE,DF,it Lazio,27,1992,8.0,10,2,6,4,0,7,10,70.0,3,5,0,5,12,22,19,0,Matches
414,Giorgos Masouras,gr GRE,"MF,FW",gr Olympiacos,26,1994,3.2,10,6,2,7,1,5,12,41.7,7,3,0,3,3,13,4,0,Matches
415,Clinton Mata,ao ANG,DF,be Club Brugge,27,1992,5.9,9,6,5,3,1,7,9,77.8,2,3,2,1,9,18,9,0,Matches
416,Juan Mata,es ESP,FW,eng Manchester Utd,32,1988,0.7,0,0,0,0,0,0,0,,0,0,0,0,0,0,0,1,Matches
417,Nemanja Matić,rs SRB,"MF,DF",eng Manchester Utd,31,1988,2.5,5,5,0,5,0,2,3,66.7,1,2,2,0,4,9,4,0,Matches
418,Joël Matip,cm CMR,DF,eng Liverpool,28,1991,1.9,4,3,3,1,0,3,4,75.0,1,0,0,0,0,4,7,0,Matches
419,Mykola Matviyenko,ua UKR,DF,ua Shakhtar,24,1996,3.3,10,5,8,2,0,7,13,53.8,6,1,0,1,11,21,14,1,Matches
420,Eric Maxim Choupo-Moting,cm CMR,FW,de Bayern Munich,31,1989,4.3,7,2,3,2,2,2,3,66.7,1,6,1,5,0,7,2,0,Matches
421,Maycon,br BRA,MF,ua Shakhtar,23,1997,4.1,2,2,2,0,0,0,4,0.0,4,2,0,2,4,6,14,0,Matches
422,Noussair Mazraoui,ma MAR,DF,nl Ajax,22,1997,5.3,19,12,10,6,3,7,13,53.8,6,12,4,8,14,33,15,0,Matches
423,Kylian Mbappé,fr FRA,FW,fr Paris S-G,21,1998,10.0,2,1,2,0,0,0,5,0.0,5,1,0,1,1,3,7,0,Matches
424,Chancel Mbemba,cd COD,DF,pt Porto,25,1994,10.3,13,10,12,1,0,8,8,100.0,0,13,10,3,8,21,49,0,Matches
425,Weston McKennie,us USA,MF,it Juventus,21,1998,4.5,13,10,5,6,2,4,13,30.8,9,6,0,6,3,16,3,0,Matches
426,Scott McTominay,sct SCO,MF,eng Manchester Utd,23,1996,3.8,11,5,3,8,0,8,14,57.1,6,2,0,2,5,16,8,0,Matches
427,Brandon Mechele,be BEL,DF,be Club Brugge,27,1993,2.0,3,2,2,1,0,2,3,66.7,1,0,0,0,5,8,10,0,Matches
428,Arthur Melo,br BRA,MF,it Juventus,23,1996,3.7,7,6,4,2,1,4,8,50.0,4,1,0,1,2,9,1,0,Matches
429,Benjamin Mendy,fr FRA,DF,eng Manchester City,26,1994,0.9,1,0,0,0,1,0,1,0.0,1,1,0,1,2,3,0,0,Matches
430,Edouard Mendy,sn SEN,GK,eng Chelsea,28,1992,12.0,0,0,0,0,0,0,0,,0,0,0,0,0,0,3,1,Matches
431,Ferland Mendy,fr FRA,DF,es Real Madrid,25,1995,10.7,13,6,7,5,1,8,17,47.1,9,7,1,6,13,26,14,1,Matches
432,Lionel Messi,ar ARG,"FW,MF",es Barcelona,33,1987,6.0,5,2,0,2,3,2,7,28.6,5,2,0,2,2,7,0,0,Matches
433,Thomas Meunier,be BEL,DF,de Dortmund,28,1991,3.9,6,5,5,0,1,4,8,50.0,4,5,2,3,1,7,4,0,Matches
434,Simon Mignolet,be BEL,GK,be Club Brugge,32,1988,5.0,1,0,1,0,0,1,1,100.0,0,0,0,0,1,2,4,0,Matches
435,Sergej Milinković-Savić,rs SRB,MF,it Lazio,25,1995,6.5,9,5,5,4,0,3,13,23.1,10,10,2,8,15,24,10,2,Matches
436,Éder Militão,br BRA,DF,es Real Madrid,22,1998,5.3,20,12,12,6,2,8,12,66.7,4,11,6,5,10,30,18,0,Matches
437,James Milner,eng ENG,MF,eng Liverpool,34,1986,4.0,14,9,2,10,2,10,18,55.6,8,7,0,7,8,22,4,0,Matches
438,Takumi Minamino,jp JPN,"FW,MF",eng Liverpool,25,1995,2.1,3,2,0,1,2,1,7,14.3,6,5,0,5,0,3,2,0,Matches
439,Óscar Mingueza,es ESP,DF,es Barcelona,21,1999,2.7,6,2,5,1,0,5,7,71.4,2,3,2,1,10,16,1,0,Matches
440,Aleksei Miranchuk,ru RUS,"MF,FW",it Atalanta,24,1995,0.3,0,0,0,0,0,0,1,0.0,1,0,0,0,2,2,1,0,Matches
441,Anton Miranchuk,ru RUS,"MF,FW",ru Loko Moscow,24,1995,5.1,3,3,2,1,0,1,7,14.3,6,4,1,3,4,7,4,0,Matches
442,Luka Modrić,hr CRO,MF,es Real Madrid,34,1985,10.1,13,7,8,4,1,8,26,30.8,18,3,2,1,18,31,1,0,Matches
443,Johan Mojica,co COL,DF,it Atalanta,27,1992,1.1,0,0,0,0,0,0,0,,0,1,0,1,2,2,0,0,Matches
444,Júnior Moraes,ua UKR,FW,ua Shakhtar,33,1987,1.8,3,1,0,1,2,1,2,50.0,1,1,0,1,1,4,0,0,Matches
445,Álvaro Morata,es ESP,FW,it Juventus,27,1992,6.6,4,2,0,3,1,0,2,0.0,2,8,1,7,4,8,2,0,Matches
446,Mateu Morey,es ESP,DF,de Dortmund,20,2000,5.0,12,9,7,4,1,5,15,33.3,10,8,1,7,18,30,12,0,Matches
447,Ilaix Moriba,gn GUI,MF,es Barcelona,17,2003,0.1,1,1,1,0,0,0,0,,0,0,0,0,0,1,0,0,Matches
448,Andrei Mostovoy,ru RUS,"FW,DF",ru Zenit,22,1997,2.2,0,0,0,0,0,0,0,,0,1,0,1,1,1,0,0,Matches
449,Youssoufa Moukoko,de GER,FW,de Dortmund,15,2004,0.4,0,0,0,0,0,0,0,,0,2,0,2,0,0,0,0,Matches
450,Mason Mount,eng ENG,MF,eng Chelsea,21,1999,8.4,16,8,7,8,1,5,14,35.7,9,10,0,10,10,26,1,0,Matches
451,Maksim Mukhin,ru RUS,MF,ru Loko Moscow,18,2001,0.5,4,4,1,3,0,3,3,100.0,0,1,0,1,3,7,0,0,Matches
452,Nordi Mukiele,fr FRA,DF,de RB Leipzig,22,1997,6.1,14,9,9,4,1,7,15,46.7,8,9,1,8,19,33,16,3,Matches
453,Thomas Müller,de GER,"MF,FW",de Bayern Munich,30,1989,7.0,7,3,3,0,4,4,14,28.6,10,9,2,7,3,10,3,0,Matches
454,Luis Muriel,co COL,"FW,MF",it Atalanta,29,1991,3.9,6,2,1,2,3,2,8,25.0,6,2,0,2,0,6,1,0,Matches
455,Vedat Muriqi,xk KVX,FW,it Lazio,26,1994,2.0,2,0,1,1,0,2,4,50.0,2,1,0,1,3,5,1,0,Matches
456,Mateo Musacchio,ar ARG,DF,it Lazio,29,1990,0.3,1,1,1,0,0,0,0,,0,0,0,0,0,1,1,1,Matches
457,Leon Musayev,ru RUS,"MF,DF",ru Zenit,21,1999,0.6,6,1,4,2,0,3,4,75.0,1,0,0,0,1,7,1,0,Matches
458,Jamal Musiala,de GER,MF,de Bayern Munich,17,2003,2.6,9,6,3,3,3,2,9,22.2,7,2,0,2,1,10,0,0,Matches
459,Enock Mwepu,zm ZAM,"MF,FW",at RB Salzburg,22,1998,5.8,17,5,7,8,2,6,21,28.6,15,6,0,6,8,25,5,0,Matches
460,Vitaliy Mykolenko,ua UKR,DF,ua Dynamo Kyiv,21,1999,3.9,5,3,3,2,0,5,8,62.5,3,2,0,2,12,17,11,0,Matches
461,Joakim Mæhle,dk DEN,DF,it Atalanta,23,1997,1.9,6,4,3,3,0,3,5,60.0,2,4,1,3,3,9,0,0,Matches
462,Nacho,es ESP,DF,es Real Madrid,30,1990,8.0,18,8,12,5,1,11,21,52.4,10,8,1,7,12,30,20,0,Matches
463,Yuto Nagatomo,jp JPN,DF,fr Marseille,33,1986,1.1,0,0,0,0,0,0,0,,0,2,1,1,0,0,1,0,Matches
464,Radja Nainggolan,be BEL,MF,it Inter,32,1988,0.0,0,0,0,0,0,0,0,,0,0,0,0,0,0,0,0,Matches
465,Shoya Nakajima,jp JPN,"FW,MF",pt Porto,25,1994,0.8,1,0,1,0,0,0,5,0.0,5,1,0,1,0,1,0,0,Matches
466,Jesús Navas,es ESP,DF,es Sevilla,34,1985,5.1,4,4,2,1,1,3,5,60.0,2,1,0,1,7,11,2,0,Matches
467,Keylor Navas,cr CRC,GK,fr Paris S-G,33,1986,12.0,0,0,0,0,0,0,1,0.0,1,0,0,0,1,1,2,1,Matches
468,David Neres,br BRA,FW,nl Ajax,23,1997,3.4,6,4,1,3,2,1,4,25.0,3,7,0,7,0,6,0,0,Matches
469,Ruslan Neshcheret,ua UKR,GK,ua Dynamo Kyiv,18,2002,1.0,0,0,0,0,0,0,0,,0,0,0,0,0,0,0,0,Matches
470,Neto,br BRA,GK,es Barcelona,31,1989,3.0,0,0,0,0,0,0,0,,0,0,0,0,0,0,0,0,Matches
471,Manuel Neuer,de GER,GK,de Bayern Munich,34,1986,8.0,0,0,0,0,0,0,1,0.0,1,0,0,0,0,0,5,1,Matches
472,Florian Neuhaus,de GER,MF,de Gladbach,23,1997,7.8,24,12,13,8,3,15,22,68.2,7,9,3,6,9,33,8,0,Matches
473,Neymar,br BRA,"FW,MF",fr Paris S-G,28,1992,8.3,5,3,1,3,1,2,14,14.3,12,5,1,4,3,8,0,0,Matches
474,Tokmac Nguen,no NOR,"FW,MF",hu Ferencváros,26,1993,5.1,1,0,0,1,0,0,3,0.0,3,2,0,2,1,2,0,0,Matches
475,M'Baye Niang,sn SEN,FW,fr Rennes,25,1994,1.1,1,1,0,0,1,0,1,0.0,1,1,0,1,0,1,1,0,Matches
476,Saúl Ñíguez,es ESP,MF,es Atlético Madrid,25,1994,5.1,8,4,2,5,1,3,12,25.0,9,6,3,3,12,20,9,0,Matches
477,Christopher Nkunku,fr FRA,"MF,FW",de RB Leipzig,22,1997,6.5,18,17,4,7,7,8,14,57.1,6,15,0,15,8,26,2,0,Matches
478,Felix Nmecha,de GER,MF,eng Manchester City,19,2000,0.1,0,0,0,0,0,0,0,,0,1,0,1,0,0,0,0,Matches
479,Alexander Nübel,de GER,GK,de Bayern Munich,23,1996,2.0,0,0,0,0,0,0,0,,0,0,0,0,0,0,1,0,Matches
480,Gerzino Nyamsi,fr FRA,DF,fr Rennes,23,1997,2.0,4,3,1,3,0,3,3,100.0,0,0,0,0,6,10,3,0,Matches
481,Steven Nzonzi,fr FRA,MF,fr Rennes,31,1988,4.7,3,2,1,2,0,1,5,20.0,4,0,0,0,2,5,6,0,Matches
482,Jan Oblak,si SVN,GK,es Atlético Madrid,27,1993,8.0,0,0,0,0,0,0,0,,0,0,0,0,0,0,1,0,Matches
483,Lucas Ocampos,ar ARG,"FW,DF",es Sevilla,26,1994,5.0,4,0,0,1,3,1,13,7.7,12,12,1,11,6,10,4,0,Matches
484,Álvaro Odriozola,es ESP,DF,es Real Madrid,24,1995,0.4,4,3,3,1,0,1,1,100.0,0,1,0,1,1,5,1,0,Matches
485,Noah Okafor,ch SUI,"FW,MF",at RB Salzburg,20,2000,0.6,3,2,0,3,0,1,1,100.0,0,1,0,1,0,3,1,0,Matches
486,David Okereke,ng NGA,"MF,FW",be Club Brugge,22,1997,0.3,0,0,0,0,0,0,3,0.0,3,0,0,0,0,0,0,0,Matches
487,Masaya Okugawa,jp JPN,"MF,FW",at RB Salzburg,24,1996,0.5,1,0,0,1,0,0,0,,0,0,0,0,1,2,0,0,Matches
488,Sérgio Oliveira,pt POR,MF,pt Porto,28,1992,8.2,15,10,6,8,1,5,25,20.0,20,12,1,11,4,19,8,0,Matches
489,Dani Olmo,es ESP,"FW,MF",de RB Leipzig,22,1998,6.5,10,7,2,7,1,3,12,25.0,9,6,0,6,6,16,3,0,Matches
490,Kristoffer Olsson,se SWE,"MF,FW",ru Krasnodar,25,1995,4.5,4,2,2,2,0,2,9,22.2,7,9,3,6,7,11,4,0,Matches
491,André Onana,cm CMR,GK,nl Ajax,24,1996,6.0,0,0,0,0,0,0,1,0.0,1,0,0,0,0,0,0,2,Matches
492,Jérôme Onguéné,cm CMR,DF,at RB Salzburg,22,1997,0.5,0,0,0,0,0,0,0,,0,1,0,1,3,3,5,0,Matches
493,Frank Onyeka,ng NGA,MF,dk Midtjylland,22,1998,5.6,18,12,8,9,1,5,15,33.3,10,8,1,7,18,36,9,0,Matches
494,Willi Orban,hu HUN,DF,de RB Leipzig,27,1992,3.6,9,5,6,3,0,5,12,41.7,7,5,2,3,3,12,10,1,Matches
495,Divock Origi,be BEL,FW,eng Liverpool,25,1995,2.3,2,2,0,2,0,1,4,25.0,3,2,0,2,0,2,3,0,Matches
496,Otávio,pt POR,"MF,FW",pt Porto,25,1995,7.8,24,16,11,9,4,12,31,38.7,19,7,1,6,0,24,10,0,Matches
497,Alex Oxlade-Chamberlain,eng ENG,MF,eng Liverpool,26,1993,0.3,1,1,0,0,1,0,0,,0,0,0,0,0,1,0,0,Matches
498,Berkay Özcan,tr TUR,MF,tr Başakşehir,22,1998,4.9,11,7,7,4,0,5,11,45.5,6,8,4,4,5,16,3,0,Matches
499,Magomed Ozdoyev,ru RUS,MF,ru Zenit,27,1992,3.5,10,4,3,4,3,3,7,42.9,4,5,1,4,9,19,2,0,Matches
500,Cole Palmer,eng ENG,FW,eng Manchester City,18,2002,0.1,0,0,0,0,0,0,0,,0,0,0,0,0,0,0,0,Matches
501,Emerson Palmieri,it ITA,DF,eng Chelsea,25,1994,2.4,7,4,4,1,2,4,6,66.7,2,3,0,3,3,10,4,0,Matches
502,Kaio Pantaleão,br BRA,DF,ru Krasnodar,24,1995,5.8,8,4,7,1,0,3,9,33.3,6,9,6,3,13,21,19,1,Matches
503,Leandro Paredes,ar ARG,MF,fr Paris S-G,26,1994,7.4,18,5,6,10,2,8,25,32.0,17,7,2,5,18,36,10,1,Matches
504,Marco Parolo,it ITA,"MF,DF",it Lazio,35,1985,2.7,5,3,2,3,0,3,5,60.0,2,9,2,7,5,10,9,0,Matches
505,Mario Pašalić,hr CRO,MF,it Atalanta,25,1995,3.1,3,3,2,1,0,0,5,0.0,5,2,0,2,5,8,3,1,Matches
506,Felix Passlack,de GER,"FW,DF",de Dortmund,22,1998,1.3,1,1,0,1,0,0,0,,0,3,0,3,0,1,2,0,Matches
507,Alfonso Pastor,es ESP,GK,es Sevilla,19,2000,1.0,0,0,0,0,0,0,0,,0,0,0,0,0,0,1,0,Matches
508,Patric,es ESP,DF,it Lazio,27,1993,4.7,5,2,3,2,0,3,10,30.0,7,3,2,1,6,11,18,1,Matches
509,Alan Patrick,br BRA,MF,ua Shakhtar,29,1991,1.8,5,2,2,2,1,3,8,37.5,5,3,0,3,2,7,3,0,Matches
510,Giuliano de Paula,br BRA,"MF,FW",tr Başakşehir,30,1990,0.9,1,0,0,1,0,1,6,16.7,5,1,0,1,0,1,0,0,Matches
511,Paulinho,br BRA,DF,dk Midtjylland,25,1995,5.3,11,9,7,2,2,4,7,57.1,3,5,0,5,11,22,8,0,Matches
512,Benjamin Pavard,fr FRA,DF,de Bayern Munich,24,1996,6.3,12,5,4,7,1,6,10,60.0,4,5,0,5,10,22,16,0,Matches
513,Dimitri Payet,fr FRA,"FW,MF",fr Marseille,33,1987,3.8,3,2,1,1,1,0,0,,0,3,0,3,1,4,1,0,Matches
514,Pedri,es ESP,"MF,FW",es Barcelona,17,2002,5.5,12,7,5,4,3,6,18,33.3,12,13,2,11,5,17,3,0,Matches
515,Timothee Pembele,fr FRA,DF,fr Paris S-G,17,2002,0.1,0,0,0,0,0,0,1,0.0,1,0,0,0,0,0,1,0,Matches
516,Carlos de Pena,uy URU,"MF,FW",ua Dynamo Kyiv,28,1992,3.6,7,5,3,3,1,2,6,33.3,4,9,0,9,7,14,7,0,Matches
517,Pepe,pt POR,DF,pt Porto,37,1983,6.3,6,5,5,1,0,5,9,55.6,4,9,6,3,4,10,32,0,Matches
518,Andreas Pereira,br BRA,"MF,FW",it Lazio,24,1996,1.5,6,4,1,5,0,3,6,50.0,3,5,0,5,1,7,0,0,Matches
519,Danilo Pereira,pt POR,"DF,MF",fr Paris S-G,28,1991,8.7,10,7,9,0,1,3,8,37.5,5,11,6,5,20,30,44,0,Matches
520,Ivan Perišić,hr CRO,"DF,FW",it Inter,31,1989,2.7,2,1,0,2,0,0,6,0.0,6,1,0,1,3,5,3,0,Matches
521,Matteo Pessina,it ITA,MF,it Atalanta,23,1997,5.4,9,4,5,2,2,5,11,45.5,6,8,4,4,11,20,2,0,Matches
522,Sergei Petrov,ru RUS,DF,ru Krasnodar,29,1991,0.8,1,1,0,1,0,1,1,100.0,0,0,0,0,0,1,0,0,Matches
523,Luca Pfeiffer,de GER,"FW,MF",dk Midtjylland,23,1996,0.2,0,0,0,0,0,0,0,,0,0,0,0,0,0,0,0,Matches
524,Nathaniel Phillips,eng ENG,DF,eng Liverpool,23,1997,3.0,5,3,3,2,0,2,5,40.0,3,8,4,4,6,11,11,0,Matches
525,Andrea Pinamonti,it ITA,FW,it Inter,21,1999,0.1,0,0,0,0,0,0,1,0.0,1,0,0,0,0,0,0,0,Matches
526,Gerard Piqué,es ESP,DF,es Barcelona,33,1987,2.6,3,2,0,3,0,1,1,100.0,0,3,2,1,3,6,6,0,Matches
527,Łukasz Piszczek,pl POL,DF,de Dortmund,35,1985,2.5,0,0,0,0,0,0,3,0.0,3,1,1,0,4,4,3,0,Matches
528,Miralem Pjanić,ba BIH,MF,es Barcelona,30,1990,5.5,4,3,1,1,2,2,10,20.0,8,5,0,5,12,16,2,1,Matches
529,Alassane Pléa,fr FRA,FW,de Gladbach,27,1993,6.0,2,0,0,2,0,1,4,25.0,3,5,0,5,2,4,0,0,Matches
530,Paul Pogba,fr FRA,MF,eng Manchester Utd,27,1993,2.0,3,2,0,2,1,1,5,20.0,4,3,0,3,3,6,3,0,Matches
531,Carlos Ponck,cv CPV,DF,tr Başakşehir,25,1995,2.1,1,0,1,0,0,1,7,14.3,6,5,2,3,6,7,8,0,Matches
532,Denys Popov,ua UKR,DF,ua Dynamo Kyiv,21,1999,4.6,5,2,3,2,0,2,5,40.0,3,5,4,1,12,17,20,0,Matches
533,Yussuf Poulsen,dk DEN,FW,de RB Leipzig,26,1994,5.6,5,4,0,4,1,4,13,30.8,9,9,2,7,3,8,7,0,Matches
534,Danila Prokhin,ru RUS,DF,ru Zenit,19,2001,2.0,2,2,2,0,0,2,4,50.0,2,2,2,0,6,8,8,1,Matches
535,Quincy Promes,nl NED,"FW,DF",nl Ajax,28,1992,2.8,4,3,1,0,3,2,5,40.0,3,0,0,0,2,6,1,0,Matches
536,Riqui Puig,es ESP,"MF,FW",es Barcelona,20,1999,1.0,1,0,0,0,1,0,0,,0,1,0,1,2,3,0,0,Matches
537,Christian Pulisic,us USA,"FW,MF",eng Chelsea,21,1998,4.7,6,4,2,3,1,3,6,50.0,3,7,1,6,3,9,0,0,Matches
538,Andriy Pyatov,ua UKR,GK,ua Shakhtar,36,1984,1.0,0,0,0,0,0,0,0,,0,0,0,0,0,0,1,0,Matches
539,Adrien Rabiot,fr FRA,MF,it Juventus,25,1995,5.6,18,12,8,7,3,7,15,46.7,8,3,0,3,16,34,5,0,Matches
540,Nemanja Radonjić,rs SRB,"FW,MF",fr Marseille,24,1996,1.0,0,0,0,0,0,0,0,,0,0,0,0,0,0,0,0,Matches
541,Ștefan Radu,ro ROU,DF,it Lazio,33,1986,1.5,2,1,0,1,1,1,1,100.0,0,2,2,0,2,4,6,0,Matches
542,Rafael,br BRA,DF,tr Başakşehir,30,1990,5.7,21,9,11,8,2,9,26,34.6,17,13,2,11,12,33,12,0,Matches
543,Rafinha,br BRA,DF,gr Olympiacos,34,1985,6.0,5,4,4,1,0,1,7,14.3,6,2,0,2,3,8,5,0,Matches
544,Rafinha,br BRA,MF,fr Paris S-G,27,1993,1.4,2,0,0,1,1,2,2,100.0,0,3,1,2,3,5,2,0,Matches
545,Slobodan Rajković,rs SRB,DF,ru Loko Moscow,31,1989,3.0,0,0,0,0,0,0,0,,0,9,9,0,6,6,22,0,Matches
546,Ivan Rakitić,hr CRO,MF,es Sevilla,32,1988,5.1,8,5,3,3,2,4,12,33.3,8,5,1,4,6,14,5,0,Matches
547,Yaroslav Rakitskiy,ua UKR,DF,ru Zenit,30,1989,5.2,3,3,0,2,1,1,4,25.0,3,6,5,1,9,12,15,0,Matches
548,André Ramalho,br BRA,DF,at RB Salzburg,28,1992,6.0,8,3,4,4,0,3,6,50.0,3,10,5,5,12,20,30,0,Matches
549,Cristian Ramírez,ec ECU,"DF,MF",ru Krasnodar,25,1994,5.5,9,6,5,1,3,4,7,57.1,3,6,3,3,5,14,12,1,Matches
550,Sergio Ramos,es ESP,DF,es Real Madrid,34,1986,4.7,2,1,2,0,0,2,3,66.7,1,5,2,3,7,9,10,0,Matches
551,Aaron Ramsey,wls WAL,"MF,FW",it Juventus,29,1990,4.0,4,2,2,1,1,1,6,16.7,5,1,0,1,9,13,4,0,Matches
552,Lazar Ranđelović,rs SRB,"FW,MF",gr Olympiacos,22,1997,2.6,7,4,2,5,0,1,3,33.3,2,0,0,0,3,10,1,0,Matches
553,Marcus Rashford,eng ENG,FW,eng Manchester Utd,22,1997,4.6,1,1,0,1,0,1,5,20.0,4,3,0,3,0,1,3,0,Matches
554,Pepe Reina,es ESP,GK,it Lazio,37,1982,7.0,0,0,0,0,0,0,1,0.0,1,0,0,0,2,2,2,1,Matches
555,Reinier,br BRA,"MF,FW",de Dortmund,18,2002,0.2,0,0,0,0,0,0,0,,0,0,0,0,0,0,0,0,Matches
556,Karim Rekik,nl NED,DF,es Sevilla,25,1994,2.4,3,1,0,2,1,2,4,50.0,2,2,1,1,4,7,5,0,Matches
557,Marco Reus,de GER,"FW,MF",de Dortmund,31,1989,7.7,12,8,5,6,1,3,11,27.3,8,8,2,6,7,19,7,0,Matches
558,Gio Reyna,us USA,"MF,FW",de Dortmund,17,2002,5.1,4,1,1,2,1,1,7,14.3,6,2,1,1,4,8,5,0,Matches
559,Federico Ricca,uy URU,DF,be Club Brugge,25,1994,3.0,5,2,3,2,0,1,2,50.0,1,6,4,2,5,10,10,0,Matches
560,Chris Richards,us USA,DF,de Bayern Munich,20,2000,1.4,8,4,3,3,2,3,4,75.0,1,1,1,0,2,10,3,0,Matches
561,Mats Rits,be BEL,MF,be Club Brugge,27,1993,3.6,1,0,1,0,0,0,2,0.0,2,1,0,1,8,9,8,0,Matches
562,Sergi Roberto,es ESP,"DF,MF",es Barcelona,28,1992,2.0,6,5,2,3,1,3,5,60.0,2,0,0,0,4,10,2,0,Matches
563,Andrew Robertson,sct SCO,DF,eng Liverpool,26,1994,8.4,6,3,4,1,1,3,8,37.5,5,7,1,6,6,12,12,0,Matches
564,Marc Roca,es ESP,MF,de Bayern Munich,23,1996,1.7,1,0,0,1,0,0,0,,0,2,0,2,2,3,4,0,Matches
565,Rodri,es ESP,MF,eng Manchester City,24,1996,8.7,11,8,2,8,1,4,16,25.0,12,7,1,6,9,20,9,2,Matches
566,Gerson Rodrigues,lu LUX,"FW,MF",ua Dynamo Kyiv,25,1995,2.0,5,1,3,0,2,0,5,0.0,5,5,0,5,3,8,4,0,Matches
567,Pedro Rodrigues,pt POR,MF,gr Olympiacos,23,1997,1.4,0,0,0,0,0,0,3,0.0,3,1,0,1,1,1,1,0,Matches
568,Óscar Rodríguez Arnaiz,es ESP,MF,es Sevilla,22,1998,3.1,7,5,1,5,1,1,9,11.1,8,4,1,3,2,9,0,0,Matches
569,Rodrygo,br BRA,"FW,MF",es Real Madrid,19,2001,3.6,7,2,5,2,0,4,9,44.4,5,5,0,5,2,9,2,0,Matches
570,Cristian Romero,ar ARG,DF,it Atalanta,22,1998,6.9,18,9,13,3,2,4,13,30.8,9,19,6,13,30,48,28,0,Matches
571,Cristiano Ronaldo,pt POR,FW,it Juventus,35,1985,6.3,0,0,0,0,0,0,3,0.0,3,1,1,0,2,2,5,0,Matches
572,Valentin Rongier,fr FRA,MF,fr Marseille,25,1994,4.9,11,8,4,6,1,6,9,66.7,3,7,0,7,20,31,3,1,Matches
573,Marten de Roon,nl NED,MF,it Atalanta,29,1991,5.3,10,9,2,7,1,4,18,22.2,14,5,0,5,12,22,6,0,Matches
574,Antonio Rüdiger,de GER,DF,eng Chelsea,27,1993,10.3,6,4,2,3,1,4,7,57.1,3,13,8,5,5,11,40,0,Matches
575,Daniele Rugani,it ITA,DF,fr Rennes,26,1994,0.2,0,0,0,0,0,0,0,,0,1,1,0,0,0,3,0,Matches
576,Matteo Ruggeri,it ITA,"DF,MF",it Atalanta,18,2002,0.2,0,0,0,0,0,0,0,,0,0,0,0,1,1,0,0,Matches
577,Georginio Rutter,fr FRA,FW,fr Rennes,18,2002,0.2,2,2,1,0,1,0,0,,0,0,0,0,0,2,0,0,Matches
578,Dmitrii Rybchinskii,ru RUS,MF,ru Loko Moscow,21,1998,1.7,5,4,5,0,0,4,7,57.1,3,1,0,1,8,13,3,0,Matches
579,Maciej Rybus,pl POL,DF,ru Loko Moscow,30,1989,6.0,5,3,4,1,0,2,9,22.2,7,5,3,2,16,21,29,0,Matches
580,José Sá,pt POR,GK,gr Olympiacos,27,1993,6.0,0,0,0,0,0,0,0,,0,0,0,0,2,2,2,0,Matches
581,Marcel Sabitzer,at AUT,MF,de RB Leipzig,26,1994,6.3,14,6,4,10,0,7,18,38.9,11,5,3,2,12,26,8,1,Matches
582,Leon Sabua,ru RUS,FW,ru Krasnodar,19,2000,0.4,0,0,0,0,0,0,0,,0,0,0,0,0,0,0,0,Matches
583,Matvei Safonov,ru RUS,GK,ru Krasnodar,21,1999,4.0,0,0,0,0,0,0,0,,0,0,0,0,0,0,2,1,Matches
584,Hiroki Sakai,jp JPN,DF,fr Marseille,30,1990,6.0,9,8,7,2,0,3,8,37.5,5,8,1,7,12,21,10,1,Matches
585,Mohamed Salah,eg EGY,FW,eng Liverpool,28,1992,8.6,6,6,1,4,1,2,8,25.0,6,6,0,6,5,11,3,1,Matches
586,Romain Salin,fr FRA,GK,fr Rennes,36,1984,2.0,0,0,0,0,0,0,0,,0,0,0,0,0,0,1,0,Matches
587,Alexis Sánchez,cl CHI,"FW,MF",it Inter,31,1988,1.3,2,1,1,0,1,0,1,0.0,1,1,0,1,3,5,0,0,Matches
588,Jadon Sancho,eng ENG,"FW,MF",de Dortmund,20,2000,4.3,3,1,2,0,1,1,4,25.0,3,0,0,0,4,7,1,0,Matches
589,Alex Sandro,br BRA,DF,it Juventus,29,1991,5.3,10,6,4,3,3,5,13,38.5,8,9,1,8,15,25,8,0,Matches
590,Leroy Sané,de GER,"FW,MF",de Bayern Munich,24,1996,6.4,7,5,2,2,3,3,14,21.4,11,5,0,5,5,12,1,0,Matches
591,Morgan Sanson,fr FRA,MF,fr Marseille,25,1994,4.1,9,6,3,4,2,2,11,18.2,9,6,0,6,5,14,0,0,Matches
592,Douglas Santos,br BRA,DF,ru Zenit,26,1994,4.4,13,8,8,4,1,7,16,43.8,9,9,0,9,9,22,7,0,Matches
593,Zaidu Sanusi,ng NGA,DF,pt Porto,23,1997,9.6,19,14,13,6,0,13,20,65.0,7,11,3,8,13,32,26,0,Matches
594,Pablo Sarabia,es ESP,"FW,MF",fr Paris S-G,28,1992,1.6,3,3,1,2,0,0,3,0.0,3,2,1,1,2,5,1,0,Matches
595,Bouna Sarr,sn SEN,DF,de Bayern Munich,28,1992,2.1,1,1,0,1,0,0,2,0.0,2,3,0,3,2,3,5,0,Matches
596,Malang Sarr,fr FRA,DF,pt Porto,21,1999,4.7,2,1,2,0,0,1,1,100.0,0,5,5,0,6,8,24,1,Matches
597,Stefan Savić,me MNE,DF,es Atlético Madrid,29,1991,7.9,6,3,2,3,1,2,4,50.0,2,7,5,2,8,14,40,0,Matches
598,Alexander Scholz,dk DEN,DF,dk Midtjylland,27,1992,6.0,9,4,7,2,0,5,9,55.6,4,8,3,5,12,21,21,0,Matches
599,Siebe Schrijvers,be BEL,"MF,FW",be Club Brugge,24,1996,0.3,0,0,0,0,0,0,0,,0,1,0,1,1,1,0,0,Matches
600,Nico Schulz,de GER,"DF,FW",de Dortmund,27,1993,2.3,3,2,1,1,1,1,4,25.0,3,0,0,0,1,4,9,0,Matches
601,Perr Schuurs,nl NED,DF,nl Ajax,20,1999,5.6,8,4,6,2,0,5,9,55.6,4,11,5,6,10,18,17,1,Matches
602,Rúben Semedo,pt POR,DF,gr Olympiacos,26,1994,5.9,4,0,2,2,0,2,5,40.0,3,5,4,1,12,16,22,1,Matches
603,Stefano Sensi,it ITA,MF,it Inter,24,1995,0.1,0,0,0,0,0,0,1,0.0,1,0,0,0,0,0,0,0,Matches
604,Artem Shabanov,ua UKR,DF,ua Dynamo Kyiv,28,1992,1.0,2,0,2,0,0,2,2,100.0,0,0,0,0,1,3,3,0,Matches
605,Daniil Shamkin,ru RUS,MF,ru Zenit,18,2002,0.4,3,2,2,1,0,1,2,50.0,1,1,0,1,1,4,3,0,Matches
606,Mykola Shaparenko,ua UKR,MF,ua Dynamo Kyiv,21,1998,4.7,14,9,6,6,2,4,13,30.8,9,5,1,4,6,20,4,0,Matches
607,Xherdan Shaqiri,ch SUI,"MF,FW",eng Liverpool,28,1991,1.8,1,0,1,0,0,1,3,33.3,2,5,0,5,3,4,1,0,Matches
608,Luke Shaw,eng ENG,DF,eng Manchester Utd,25,1995,3.7,7,5,2,4,1,4,4,100.0,0,3,0,3,8,15,6,0,Matches
609,Volodymyr Shepelyev,ua UKR,MF,ua Dynamo Kyiv,23,1997,2.9,2,0,1,1,0,0,3,0.0,3,1,1,0,5,7,3,0,Matches
610,Dávid Sigér,hu HUN,MF,hu Ferencváros,29,1990,4.3,3,0,0,2,1,1,4,25.0,3,3,1,2,5,8,2,1,Matches
611,Bernardo Silva,pt POR,"MF,FW",eng Manchester City,25,1994,10.3,12,8,1,7,4,5,15,33.3,10,11,1,10,4,16,5,1,Matches
612,Thiago Silva,br BRA,DF,eng Chelsea,35,1984,6.3,6,3,4,2,0,3,6,50.0,3,7,3,4,8,14,23,0,Matches
613,Aleksandr Silyanov,ru RUS,MF,ru Loko Moscow,19,2001,0.0,1,0,1,0,0,1,1,100.0,0,0,0,0,0,1,1,0,Matches
614,Pione Sisto,dk DEN,"MF,FW",dk Midtjylland,25,1995,3.8,3,2,1,1,1,0,7,0.0,7,3,1,2,1,4,0,0,Matches
615,Milan Škriniar,sk SVK,DF,it Inter,25,1995,3.0,6,3,5,1,0,2,5,40.0,3,3,2,1,2,8,4,0,Matches
616,Martin Škrtel,sk SVK,DF,tr Başakşehir,35,1984,4.5,7,5,5,2,0,4,7,57.1,3,7,3,4,8,15,19,0,Matches
617,Igor Smolnikov,ru RUS,"DF,MF",ru Krasnodar,31,1988,5.0,6,3,4,1,1,2,5,40.0,3,6,4,2,8,14,18,0,Matches
618,Fyodor Smolov,ru RUS,"FW,MF",ru Loko Moscow,30,1990,2.2,1,0,0,1,0,0,0,,0,1,0,1,3,4,1,0,Matches
619,Eduard Sobol,ua UKR,"DF,FW",be Club Brugge,25,1995,3.5,5,5,1,3,1,3,3,100.0,0,1,0,1,2,7,5,0,Matches
620,Manor Solomon,il ISR,"MF,FW",ua Shakhtar,21,1999,4.1,3,3,1,1,1,2,7,28.6,5,4,0,4,5,8,0,0,Matches
621,Somália,br BRA,MF,hu Ferencváros,31,1988,5.2,7,3,4,2,1,3,6,50.0,3,3,0,3,11,18,2,0,Matches
622,Yann Sommer,ch SUI,GK,de Gladbach,31,1988,8.0,0,0,0,0,0,0,0,,0,0,0,0,0,0,2,0,Matches
623,Brandon Soppy,fr FRA,DF,fr Rennes,18,2002,1.8,0,0,0,0,0,0,2,0.0,2,1,1,0,0,0,3,0,Matches
624,Yegor Sorokin,ru RUS,DF,ru Krasnodar,24,1995,1.7,1,1,0,1,0,0,2,0.0,2,3,2,1,6,7,12,0,Matches
625,Hillel Soudani,dz ALG,"FW,MF",gr Olympiacos,32,1987,0.4,0,0,0,0,0,0,0,,0,0,0,0,0,0,1,0,Matches
626,Eduard Spertsyan,am ARM,"FW,MF",ru Krasnodar,20,2000,0.4,1,0,1,0,0,1,3,33.3,2,0,0,0,1,2,2,0,Matches
627,Marco Sportiello,it ITA,GK,it Atalanta,28,1992,5.0,0,0,0,0,0,0,1,0.0,1,0,0,0,0,0,0,2,Matches
628,Cican Stankovic,at AUT,GK,at RB Salzburg,27,1992,6.0,0,0,0,0,0,0,0,,0,1,0,1,0,0,0,1,Matches
629,Zack Steffen,us USA,GK,eng Manchester City,25,1995,1.0,0,0,0,0,0,0,0,,0,0,0,0,0,0,0,0,Matches
630,Taras Stepanenko,ua UKR,"MF,DF",ua Shakhtar,30,1989,3.2,2,2,0,1,1,2,4,50.0,2,3,1,2,5,7,11,0,Matches
631,Raheem Sterling,eng ENG,FW,eng Manchester City,25,1994,7.2,6,2,0,3,3,0,3,0.0,3,3,0,3,3,9,0,0,Matches
632,Angelo Stiller,de GER,"MF,FW",de Bayern Munich,19,2001,0.2,1,1,1,0,0,1,1,100.0,0,0,0,0,1,2,0,0,Matches
633,Lars Stindl,de GER,"MF,FW",de Gladbach,31,1988,5.9,13,4,6,5,2,1,13,7.7,12,6,1,5,5,18,1,0,Matches
634,John Stones,eng ENG,DF,eng Manchester City,26,1994,8.9,8,4,2,4,2,2,3,66.7,1,8,7,1,9,17,24,1,Matches
635,Thomas Strakosha,al ALB,GK,it Lazio,25,1995,1.0,0,0,0,0,0,0,0,,0,0,0,0,0,0,0,0,Matches
636,Kevin Strootman,nl NED,MF,fr Marseille,30,1990,0.3,0,0,0,0,0,0,0,,0,1,0,1,1,1,0,0,Matches
637,Luis Suárez,uy URU,FW,es Atlético Madrid,33,1987,5.1,1,1,0,1,0,0,0,,0,3,2,1,1,2,5,0,Matches
638,Luka Sučić,hr CRO,"MF,FW",at RB Salzburg,17,2002,0.5,2,2,0,2,0,2,6,33.3,4,0,0,0,2,4,1,0,Matches
639,Heorhiy Sudakov,ua UKR,FW,ua Shakhtar,17,2002,0.1,0,0,0,0,0,0,1,0.0,1,0,0,0,0,0,0,0,Matches
640,Niklas Süle,de GER,DF,de Bayern Munich,24,1995,6.0,7,3,2,5,0,3,6,50.0,3,5,2,3,13,20,19,0,Matches
641,Magomed-Shapi Suleymanov,ru RUS,"FW,MF",ru Krasnodar,20,1999,2.3,6,5,3,0,3,3,5,60.0,2,4,0,4,1,7,4,0,Matches
642,Vladyslav Supriaha,ua UKR,FW,ua Dynamo Kyiv,20,2000,3.4,0,0,0,0,0,0,6,0.0,6,3,1,2,1,1,1,0,Matches
643,Suso,es ESP,FW,es Sevilla,26,1993,3.1,6,4,1,2,3,3,5,60.0,2,0,0,0,2,8,0,0,Matches
644,Aleksei Sutormin,ru RUS,DF,ru Zenit,26,1994,2.7,6,4,4,1,1,4,11,36.4,7,3,1,2,2,8,4,0,Matches
645,Erik Sviatchenko,dk DEN,DF,dk Midtjylland,28,1991,5.0,6,2,4,2,0,2,2,100.0,0,3,1,2,20,26,19,1,Matches
646,Serhiy Sydorchuk,ua UKR,MF,ua Dynamo Kyiv,29,1991,3.9,4,3,2,1,1,2,5,40.0,3,5,1,4,12,16,7,1,Matches
647,Wojciech Szczęsny,pl POL,GK,it Juventus,30,1990,7.3,1,0,1,0,0,1,1,100.0,0,0,0,0,1,2,5,1,Matches
648,Dominik Szoboszlai,hu HUN,"MF,FW",at RB Salzburg,19,2000,5.6,4,1,2,0,2,1,8,12.5,7,6,1,5,3,7,10,0,Matches
649,Alexander Sørloth,no NOR,"MF,FW",de RB Leipzig,24,1995,1.3,1,0,0,1,0,1,1,100.0,0,0,0,0,0,1,0,0,Matches
650,Dušan Tadić,rs SRB,"FW,MF",nl Ajax,31,1988,6.0,3,3,1,1,1,2,4,50.0,2,5,0,5,0,3,0,0,Matches
651,Nicolás Tagliafico,ar ARG,DF,nl Ajax,27,1992,5.7,13,7,8,4,1,6,12,50.0,6,4,1,3,7,20,15,0,Matches
652,Taison,br BRA,FW,ua Shakhtar,32,1988,3.1,4,3,4,0,0,0,4,0.0,4,5,0,5,0,4,3,0,Matches
653,Flavien Tait,fr FRA,MF,fr Rennes,27,1993,0.5,0,0,0,0,0,0,0,,0,1,0,1,1,1,0,0,Matches
654,Mehdi Taremi,ir IRN,FW,pt Porto,28,1992,2.2,0,0,0,0,0,0,2,0.0,2,3,1,2,2,2,2,0,Matches
655,Mahmut Tekdemir,tr TUR,MF,tr Başakşehir,32,1988,2.0,4,1,1,3,0,1,4,25.0,3,2,1,1,6,10,2,0,Matches
656,Alex Telles,br BRA,DF,eng Manchester Utd,27,1992,3.2,7,5,2,4,1,3,7,42.9,4,5,0,5,1,8,3,0,Matches
657,Marc-André ter Stegen,de GER,GK,es Barcelona,28,1992,5.0,0,0,0,0,0,0,0,,0,0,0,0,0,0,2,0,Matches
658,Martin Terrier,fr FRA,"FW,MF",fr Rennes,23,1997,2.7,4,4,2,2,0,3,6,50.0,3,3,0,3,4,8,2,0,Matches
659,Tetê,br BRA,"MF,FW",ua Shakhtar,20,2000,5.7,5,3,3,1,1,3,12,25.0,9,9,0,9,3,8,5,0,Matches
660,Florian Thauvin,fr FRA,"FW,MF",fr Marseille,27,1993,5.3,8,6,6,1,1,5,12,41.7,7,2,0,2,2,10,2,0,Matches
661,Marcus Thuram,fr FRA,FW,de Gladbach,22,1997,6.6,5,3,3,2,0,2,10,20.0,8,14,2,12,6,11,6,0,Matches
662,Steffen Tigges,de GER,FW,de Dortmund,22,1998,0.1,0,0,0,0,0,0,1,0.0,1,0,0,0,0,0,0,0,Matches
663,Jurriën Timber,nl NED,DF,nl Ajax,19,2001,0.0,0,0,0,0,0,0,0,,0,0,0,0,0,0,0,0,Matches
664,Corentin Tolisso,fr FRA,MF,de Bayern Munich,25,1994,2.8,1,0,0,1,0,0,2,0.0,2,3,0,3,1,2,2,0,Matches
665,Rafael Tolói,it ITA,DF,it Atalanta,29,1990,6.9,19,12,7,12,0,8,13,61.5,5,9,3,6,13,32,24,0,Matches
666,Mehmet Topal,tr TUR,"MF,DF",tr Başakşehir,34,1986,2.5,4,1,3,1,0,3,4,75.0,1,3,1,2,7,11,7,0,Matches
667,Lucas Torreira,uy URU,MF,es Atlético Madrid,24,1996,0.5,3,2,0,3,0,1,3,33.3,2,0,0,0,2,5,1,0,Matches
668,Ferrán Torres,es ESP,FW,eng Manchester City,20,2000,4.0,4,2,0,3,1,0,1,0.0,1,1,0,1,3,7,1,0,Matches
669,Óliver Torres,es ESP,"MF,FW",es Sevilla,25,1994,3.1,7,5,3,4,0,3,8,37.5,5,2,0,2,2,9,1,0,Matches
670,Hamari Traoré,ml MLI,DF,fr Rennes,28,1992,6.0,6,4,5,1,0,4,9,44.4,5,6,1,5,11,17,12,0,Matches
671,Ibrahima Traoré,gn GUI,FW,de Gladbach,32,1988,0.3,1,0,1,0,0,0,1,0.0,1,0,0,0,0,1,0,0,Matches
672,Francisco Trincão,pt POR,FW,es Barcelona,20,1999,3.7,5,4,0,1,4,0,7,0.0,7,4,0,4,2,7,0,0,Matches
673,Kieran Trippier,eng ENG,"DF,FW",es Atlético Madrid,29,1990,6.8,11,5,5,4,2,6,10,60.0,4,8,2,6,10,21,14,0,Matches
674,Anatolii Trubin,ua UKR,GK,ua Shakhtar,18,2001,5.0,0,0,0,0,0,0,2,0.0,2,0,0,0,1,1,2,1,Matches
675,Adrien Truffert,fr FRA,DF,fr Rennes,18,2001,2.7,9,6,6,1,2,4,8,50.0,4,1,0,1,5,14,7,0,Matches
676,Kostas Tsimikas,gr GRE,DF,eng Liverpool,24,1996,1.4,2,2,1,0,1,1,2,50.0,1,1,1,0,2,4,6,0,Matches
677,Viktor Tsyhankov,ua UKR,"MF,FW",ua Dynamo Kyiv,22,1997,4.7,8,4,4,3,1,2,12,16.7,10,4,1,3,5,13,4,0,Matches
678,Axel Tuanzebe,cd COD,DF,eng Manchester Utd,22,1997,2.3,5,3,4,1,0,1,2,50.0,1,1,0,1,2,7,11,0,Matches
679,Deniz Turuc,tr TUR,"MF,FW",tr Başakşehir,27,1993,5.8,1,1,1,0,0,1,7,14.3,6,6,4,2,5,6,3,0,Matches
680,Andreas Ulmer,at AUT,DF,at RB Salzburg,34,1985,6.0,18,12,10,7,1,7,14,50.0,7,7,1,6,11,29,8,0,Matches
681,Samuel Umtiti,fr FRA,DF,es Barcelona,26,1993,0.4,1,0,0,1,0,0,1,0.0,1,1,0,1,0,1,0,0,Matches
682,Dayot Upamecano,fr FRA,DF,de RB Leipzig,21,1998,6.7,22,16,15,7,0,11,15,73.3,4,6,2,4,14,36,13,2,Matches
683,Mateus Uribe,co COL,MF,pt Porto,29,1991,8.3,20,14,11,8,1,5,12,41.7,7,7,0,7,8,28,12,0,Matches
684,Daniil Utkin,ru RUS,"MF,FW",ru Krasnodar,20,1999,2.5,2,2,1,1,0,0,1,0.0,1,4,0,4,0,2,1,0,Matches
685,Myrto Uzuni,al ALB,"MF,FW",hu Ferencváros,25,1995,2.7,1,1,0,1,0,0,3,0.0,3,2,0,2,2,3,1,0,Matches
686,Tomáš Vaclík,cz CZE,GK,es Sevilla,31,1989,2.0,0,0,0,0,0,0,1,0.0,1,0,0,0,0,0,0,0,Matches
687,Mathieu Valbuena,fr FRA,"FW,MF",gr Olympiacos,35,1984,2.8,4,2,1,3,0,0,1,0.0,1,2,0,2,1,5,0,0,Matches
688,Albert Vallci,at AUT,DF,at RB Salzburg,25,1995,1.0,2,0,0,2,0,1,4,25.0,3,2,0,2,3,5,3,0,Matches
689,Federico Valverde,uy URU,"MF,DF",es Real Madrid,22,1998,5.4,13,8,5,2,6,6,12,50.0,6,10,1,9,17,30,4,0,Matches
690,Thomas Van den Keybus,be BEL,DF,be Club Brugge,19,2001,0.0,0,0,0,0,0,0,0,,0,0,0,0,0,0,0,0,Matches
691,Ignace Van Der Brempt,be BEL,DF,be Club Brugge,18,2002,0.1,0,0,0,0,0,0,0,,0,0,0,0,1,1,0,0,Matches
692,Hans Vanaken,be BEL,MF,be Club Brugge,27,1992,5.9,5,3,2,3,0,2,8,25.0,6,4,0,4,8,13,6,0,Matches
693,Raphaël Varane,fr FRA,DF,es Real Madrid,27,1993,9.0,11,4,8,2,1,2,4,50.0,2,5,3,2,14,25,32,1,Matches
694,Franco Vázquez,ar ARG,"FW,MF",es Sevilla,31,1989,1.0,3,2,0,3,0,2,4,50.0,2,1,1,0,1,4,0,0,Matches
695,Lucas Vázquez,es ESP,"DF,FW",es Real Madrid,29,1991,8.0,16,12,6,8,2,9,23,39.1,14,10,0,10,6,22,9,0,Matches
696,Benjamin Verbič,si SVN,FW,ua Dynamo Kyiv,26,1993,3.2,4,2,0,3,1,1,7,14.3,6,6,0,6,2,6,1,0,Matches
697,Marco Verratti,it ITA,"MF,FW",fr Paris S-G,27,1992,5.6,21,10,8,10,3,11,23,47.8,12,4,1,3,6,27,2,0,Matches
698,Lasse Vibe,dk DEN,"FW,MF",dk Midtjylland,33,1987,0.5,1,1,0,1,0,0,0,,0,0,0,0,0,1,0,0,Matches
699,Arturo Vidal,cl CHI,MF,it Inter,33,1987,3.2,12,8,2,9,1,4,11,36.4,7,5,0,5,6,18,3,1,Matches
700,Fabio Vieira,pt POR,MF,pt Porto,20,2000,1.8,5,2,4,0,1,2,3,66.7,1,1,0,1,1,6,1,0,Matches
701,Tonny Vilhena,nl NED,MF,ru Krasnodar,25,1995,4.3,9,3,4,5,0,5,17,29.4,12,3,0,3,6,15,8,0,Matches
702,Rúben Vinagre,pt POR,"DF,FW",gr Olympiacos,21,1999,0.2,1,0,0,1,0,0,0,,0,0,0,0,0,1,1,0,Matches
703,Edin Višća,ba BIH,MF,tr Başakşehir,30,1990,4.7,4,2,0,2,2,2,5,40.0,3,5,0,5,3,7,2,0,Matches
704,Vitão,br BRA,DF,ua Shakhtar,20,2000,1.4,3,2,3,0,0,3,4,75.0,1,2,2,0,5,8,11,0,Matches
705,Vitolo,es ESP,"MF,DF",es Atlético Madrid,30,1989,0.3,2,0,0,1,1,1,1,100.0,0,1,0,1,0,2,0,0,Matches
706,Bohdan Viunnyk,ua UKR,MF,ua Shakhtar,18,2002,0.0,0,0,0,0,0,0,0,,0,0,0,0,0,0,0,0,Matches
707,Ruud Vormer,nl NED,MF,be Club Brugge,32,1988,5.7,11,10,2,6,3,4,7,57.1,3,1,0,1,8,19,1,1,Matches
708,Stefan de Vrij,nl NED,DF,it Inter,28,1992,6.0,6,5,2,4,0,3,4,75.0,1,8,4,4,17,23,16,0,Matches
709,Marious Vrousai,gr GRE,"FW,DF",gr Olympiacos,22,1998,2.1,6,2,3,2,1,1,2,50.0,1,2,0,2,5,11,2,0,Matches
710,Kyle Walker,eng ENG,DF,eng Manchester City,30,1990,10.9,23,12,8,9,6,10,14,71.4,4,6,1,5,14,37,17,0,Matches
711,Aaron Wan-Bissaka,eng ENG,DF,eng Manchester Utd,22,1997,5.2,14,6,9,4,1,9,12,75.0,3,10,2,8,9,23,15,0,Matches
712,Wanderson,br BRA,"FW,MF",ru Krasnodar,25,1994,2.3,3,1,1,1,1,1,2,50.0,1,1,0,1,2,5,0,0,Matches
713,Wendel,br BRA,"MF,FW",ru Zenit,22,1997,1.6,4,3,2,2,0,3,8,37.5,5,1,0,1,2,6,1,0,Matches
714,Oscar Wendt,se SWE,DF,de Gladbach,34,1985,2.4,7,5,4,2,1,3,6,50.0,3,5,3,2,6,13,4,0,Matches
715,Timo Werner,de GER,FW,eng Chelsea,24,1996,9.0,6,4,2,4,0,2,13,15.4,11,9,0,9,6,12,3,0,Matches
716,Georginio Wijnaldum,nl NED,MF,eng Liverpool,29,1990,8.0,7,2,2,5,0,0,4,0.0,4,4,0,4,9,16,2,0,Matches
717,Brandon Williams,eng ENG,DF,eng Manchester Utd,19,2000,0.7,1,0,0,1,0,0,0,,0,1,0,1,1,2,2,0,Matches
718,Neco Williams,wls WAL,DF,eng Liverpool,19,2001,2.1,7,4,4,3,0,2,3,66.7,1,4,1,3,6,13,3,1,Matches
719,Rhys Williams,eng ENG,DF,eng Liverpool,19,2001,3.7,4,3,2,2,0,2,5,40.0,3,0,0,0,5,9,13,0,Matches
720,Axel Witsel,be BEL,"MF,DF",de Dortmund,31,1989,4.0,8,6,2,3,3,1,5,20.0,4,1,1,0,7,15,5,0,Matches
721,Maximilian Wöber,at AUT,DF,at RB Salzburg,22,1998,5.7,10,7,9,1,0,3,11,27.3,8,5,4,1,11,21,31,0,Matches
722,Hannes Wolf,at AUT,"MF,FW",de Gladbach,21,1999,0.9,1,1,1,0,0,0,2,0.0,2,2,0,2,0,1,1,0,Matches
723,Ashley Young,eng ENG,DF,it Inter,35,1985,4.6,4,3,2,2,0,2,4,50.0,2,1,0,1,3,7,6,0,Matches
724,Illia Zabarnyi,ua UKR,DF,ua Dynamo Kyiv,17,2002,6.0,2,1,2,0,0,2,7,28.6,5,6,5,1,8,10,34,0,Matches
725,Dan-Axel Zagadou,fr FRA,DF,de Dortmund,21,1999,0.2,1,0,1,0,0,0,0,,0,1,1,0,1,2,7,0,Matches
726,Denis Zakaria,ch SUI,"MF,DF",de Gladbach,23,1996,3.2,10,7,8,2,0,4,7,57.1,3,2,1,1,3,13,4,0,Matches
727,Duván Zapata,co COL,FW,it Atalanta,29,1991,5.8,4,3,2,2,0,1,1,100.0,0,2,0,2,1,5,10,0,Matches
728,Rifat Zhemaletdinov,ru RUS,"MF,FW",ru Loko Moscow,23,1996,1.2,2,0,2,0,0,2,2,100.0,0,2,0,2,0,2,3,0,Matches
729,Yuri Zhirkov,ru RUS,"MF,DF",ru Zenit,36,1983,1.8,2,2,0,1,1,2,3,66.7,1,2,1,1,2,4,3,0,Matches
730,Dmitri Zhivoglyadov,ru RUS,DF,ru Loko Moscow,26,1994,5.9,9,6,7,1,1,5,8,62.5,3,7,3,4,8,17,20,0,Matches
731,Oleksandr Zinchenko,ua UKR,DF,eng Manchester City,23,1996,6.5,12,7,7,5,0,7,12,58.3,5,7,1,6,4,16,12,0,Matches
732,Joshua Zirkzee,nl NED,FW,de Bayern Munich,19,2001,0.1,0,0,0,0,0,0,1,0.0,1,0,0,0,0,0,0,0,Matches
733,Hakim Ziyech,ma MAR,"FW,MF",eng Chelsea,27,1993,3.9,9,6,2,3,4,3,11,27.3,8,2,0,2,4,13,2,0,Matches
734,Kurt Zouma,fr FRA,DF,eng Chelsea,25,1994,5.0,3,2,1,2,0,2,4,50.0,2,5,5,0,2,5,23,0,Matches
735,Oleksandr Zubkov,ua UKR,"FW,MF",hu Ferencváros,23,1996,4.3,5,5,1,2,2,2,7,28.6,5,3,1,2,4,9,4,0,Matches
736,Martin Ødegaard,no NOR,MF,es Real Madrid,21,1998,1.5,2,1,0,1,1,2,4,50.0,2,0,0,0,0,2,1,0,Matches
