Rk,Player,Nation,Pos,Squad,Age,Born,90s,Tackles_Tkl,Tackles_TklW,Tackles_Def_3rd,Tackles_Mid_3rd,Tackles_Att_3rd,Challenges_Tkl,Challenges_Att,Challenges_Tkl%,Challenges_Lost,Blocks_Blocks,Blocks_Sh,Blocks_Pass,Int,Tkl+Int,Clr,Err,Matches
1,Vincent Aboubakar,cm CMR,FW,pt Porto,25,1992,5.5,1,0,1,0,0,0,0,,0,0,0,0,0,1,1,0,Matches
2,Marcos Acuña,ar ARG,"FW,DF",pt Sporting CP,25,1991,4.8,7,5,3,3,1,0,2,0.0,2,4,0,4,8,15,3,0,Matches
3,Tosin Adarabioyo,eng ENG,DF,eng Manchester City,19,1997,1.0,0,0,0,0,0,0,1,0.0,1,0,0,0,2,2,3,0,Matches
4,Adriano,br BRA,DF,tr Beşiktaş,32,1984,5.4,15,12,5,9,1,8,13,61.5,5,2,0,2,11,26,19,2,Matches
5,Luiz Adriano,br BRA,"FW,MF",ru Spartak Moscow,30,1987,6.0,8,6,2,3,3,1,4,25.0,3,5,1,4,1,9,16,0,Matches
6,Ansi Agolli,al ALB,DF,az Qarabağ,34,1982,4.0,7,5,6,1,0,2,2,100.0,0,5,1,4,6,13,15,0,Matches
7,Sergio Agüero,ar ARG,FW,eng Manchester City,29,1988,4.9,3,2,1,1,1,0,3,0.0,3,4,0,4,3,6,0,0,Matches
8,Karim El Ahmadi,ma MAR,MF,nl Feyenoord,32,1985,4.0,9,6,4,5,0,1,6,16.7,5,10,0,10,3,12,4,0,Matches
9,Valon Ahmedi,al ALB,"MF,FW",si NK Maribor,22,1994,2.5,2,1,1,1,0,2,4,50.0,2,1,0,1,0,2,2,0,Matches
10,Albian Ajeti,ch SUI,FW,ch Basel,20,1997,1.1,1,0,0,1,0,0,1,0.0,1,0,0,0,0,1,0,0,Matches
11,Manuel Akanji,ch SUI,DF,ch Basel,22,1995,6.0,8,5,8,0,0,4,11,36.4,7,11,5,6,13,21,32,0,Matches
12,Igor Akinfeev,ru RUS,GK,ru CSKA Moscow,31,1986,6.0,0,0,0,0,0,0,0,,0,0,0,0,1,1,4,1,Matches
13,David Alaba,at AUT,DF,de Bayern Munich,25,1992,6.9,7,5,3,2,2,2,5,40.0,3,5,2,3,7,14,9,2,Matches
14,Jordi Alba,es ESP,DF,es Barcelona,28,1989,7.1,12,6,7,4,1,5,13,38.5,8,9,3,6,10,22,15,0,Matches
15,Raúl Albiol,es ESP,DF,it Napoli,31,1985,5.0,8,5,7,1,0,5,6,83.3,1,6,5,1,6,14,16,1,Matches
16,Paco Alcácer,es ESP,FW,es Barcelona,23,1993,1.1,1,0,1,0,0,0,0,,0,2,0,2,2,3,0,0,Matches
17,Thiago Alcántara,es ESP,MF,de Bayern Munich,26,1991,6.7,26,19,7,16,3,8,19,42.1,11,12,1,11,14,40,2,0,Matches
18,Toby Alderweireld,be BEL,DF,eng Tottenham,28,1989,3.3,6,5,3,3,0,4,6,66.7,2,5,2,3,2,8,20,0,Matches
19,Trent Alexander-Arnold,eng ENG,DF,eng Liverpool,18,1998,9.1,25,14,16,8,1,16,28,57.1,12,4,2,2,22,47,27,1,Matches
20,Nektarios Alexandrou,cy CYP,"DF,MF",cy APOEL FC,33,1983,0.6,1,1,0,1,0,0,1,0.0,1,1,1,0,1,2,2,0,Matches
21,Alisson,br BRA,GK,it Roma,24,1992,12.0,1,1,1,0,0,0,1,0.0,1,0,0,0,1,2,7,1,Matches
22,Allan,br BRA,MF,it Napoli,26,1991,3.4,8,5,1,5,2,2,13,15.4,11,7,0,7,3,11,2,0,Matches
23,Dele Alli,eng ENG,"MF,FW",eng Tottenham,21,1996,4.8,11,6,3,6,2,1,5,20.0,4,2,0,2,1,12,1,0,Matches
24,André Almeida,pt POR,DF,pt Benfica,26,1990,2.9,6,4,2,2,2,5,5,100.0,0,2,1,1,4,10,3,0,Matches
25,André Almeida Pinto,pt POR,DF,pt Sporting CP,27,1989,2.0,3,2,1,2,0,2,2,100.0,0,4,3,1,2,5,5,0,Matches
26,Richard Almeida,az AZE,MF,az Qarabağ,28,1989,6.0,12,5,5,6,1,2,15,13.3,13,3,1,2,4,16,5,0,Matches
27,Stathis Aloneftis,cy CYP,"FW,MF",cy APOEL FC,34,1983,5.6,9,7,4,4,1,3,18,16.7,15,6,0,6,10,19,8,0,Matches
28,Marcos Alonso,es ESP,"DF,MF",eng Chelsea,26,1990,6.6,13,10,6,5,2,6,14,42.9,8,11,1,10,12,25,11,0,Matches
29,Éder Álvarez Balanta,co COL,DF,ch Basel,24,1993,5.9,14,9,11,3,0,5,12,41.7,7,9,4,5,12,26,33,0,Matches
30,Dani Alves,br BRA,DF,fr Paris S-G,34,1983,8.0,24,15,14,7,3,7,18,38.9,11,13,2,11,13,37,14,1,Matches
31,Sofyan Amrabat,ma MAR,"MF,DF",nl Feyenoord,20,1996,5.9,12,12,7,4,1,1,9,11.1,8,9,0,9,9,21,4,1,Matches
32,André André,pt POR,"MF,FW",pt Porto,27,1989,2.5,6,3,4,2,0,1,3,33.3,2,4,1,3,2,8,4,0,Matches
33,Thanasis Androutsos,gr GRE,FW,gr Olympiacos,20,1997,1.0,1,0,1,0,0,1,5,20.0,4,1,0,1,0,1,1,0,Matches
34,Minas Antoniou,cy CYP,FW,cy APOEL FC,23,1994,0.1,2,2,1,1,0,2,2,100.0,0,0,0,0,0,2,0,0,Matches
35,Mirko Antonucci,it ITA,FW,it Roma,18,1999,0.2,0,0,0,0,0,0,0,,0,0,0,0,0,0,0,0,Matches
36,Dennis Appiah,fr FRA,"DF,MF",be Anderlecht,25,1992,5.7,18,13,10,8,0,10,20,50.0,10,10,1,9,6,24,14,1,Matches
37,Alphonse Areola,fr FRA,GK,fr Paris S-G,24,1993,8.0,0,0,0,0,0,0,0,,0,0,0,0,0,0,5,0,Matches
38,Stuart Armstrong,sct SCO,MF,sct Celtic,25,1992,2.6,6,1,0,6,0,0,9,0.0,9,2,0,2,5,11,1,0,Matches
39,Tolgay Arslan,de GER,MF,tr Beşiktaş,26,1990,3.6,15,11,4,11,0,4,15,26.7,11,6,0,6,4,19,1,0,Matches
40,Kwadwo Asamoah,gh GHA,DF,it Juventus,28,1988,1.1,2,2,2,0,0,1,3,33.3,2,2,1,1,2,4,3,0,Matches
41,Marco Asensio,es ESP,"MF,FW",es Real Madrid,21,1996,5.2,4,3,2,1,1,0,4,0.0,4,2,1,1,3,7,5,0,Matches
42,Pierre-Emerick Aubameyang,ga GAB,FW,de Dortmund,28,1989,6.0,1,0,0,0,1,0,2,0.0,2,3,0,3,0,1,0,0,Matches
43,Jean-Kévin Augustin,fr FRA,FW,de RB Leipzig,20,1997,3.8,0,0,0,0,0,0,0,,0,6,0,6,1,1,0,0,Matches
44,Filipe Augusto,br BRA,MF,pt Benfica,23,1993,2.6,4,3,0,4,0,1,4,25.0,3,4,1,3,5,9,1,0,Matches
45,Serge Aurier,ci CIV,DF,eng Tottenham,24,1992,5.6,8,7,6,1,1,4,12,33.3,8,3,1,2,17,25,13,0,Matches
46,Márcio Azevedo,br BRA,DF,ua Shakhtar,31,1986,0.3,0,0,0,0,0,0,1,0.0,1,0,0,0,0,0,0,0,Matches
47,César Azpilicueta,es ESP,DF,eng Chelsea,27,1989,7.8,13,8,4,7,2,8,14,57.1,6,10,6,4,17,30,14,0,Matches
48,Ryan Babel,nl NED,FW,tr Beşiktaş,30,1986,6.2,4,1,3,0,1,0,4,0.0,4,4,0,4,7,11,3,0,Matches
49,Eric Bailly,ci CIV,DF,eng Manchester Utd,23,1994,3.0,8,4,5,3,0,2,2,100.0,0,6,4,2,2,10,10,2,Matches
50,Gregor Bajde,si SVN,"MF,FW",si NK Maribor,23,1994,2.8,9,4,6,2,1,4,11,36.4,7,3,0,3,3,12,4,0,Matches
51,Tiemoué Bakayoko,fr FRA,MF,eng Chelsea,22,1994,4.0,12,11,3,6,3,2,6,33.3,4,3,0,3,7,19,2,0,Matches
52,Keita Baldé,sn SEN,"FW,MF",fr Monaco,22,1995,3.2,0,0,0,0,0,0,2,0.0,2,0,0,0,1,1,0,0,Matches
53,Gareth Bale,wls WAL,"FW,MF",es Real Madrid,28,1989,3.3,2,1,0,1,1,1,1,100.0,0,3,0,3,1,3,6,0,Matches
54,Éver Banega,ar ARG,MF,es Sevilla,29,1988,8.8,13,9,2,9,2,6,22,27.3,16,5,2,3,6,19,2,0,Matches
55,Gabriel Barbosa,br BRA,"MF,DF",pt Benfica,20,1996,0.3,2,2,0,2,0,0,0,,0,0,0,0,1,3,0,0,Matches
56,Marc Bartra,es ESP,"DF,MF",de Dortmund,26,1991,3.9,17,10,10,4,3,8,14,57.1,6,9,2,7,11,28,16,0,Matches
57,Andrea Barzagli,it ITA,DF,it Juventus,36,1981,7.3,13,8,12,1,0,7,11,63.6,4,2,1,1,13,26,21,0,Matches
58,Bilal Başaçıkoğlu,tr TUR,FW,nl Feyenoord,22,1995,0.3,1,1,0,0,1,0,0,,0,1,0,1,0,1,0,0,Matches
59,Michy Batshuayi,be BEL,FW,eng Chelsea,23,1993,1.4,0,0,0,0,0,0,1,0.0,1,0,0,0,0,0,2,0,Matches
60,Rodrigo Battaglia,ar ARG,MF,pt Sporting CP,26,1991,6.0,17,14,6,10,1,9,18,50.0,9,8,2,6,9,26,9,0,Matches
61,Sven van Beek,nl NED,DF,nl Feyenoord,23,1994,3.0,5,2,2,2,1,1,2,50.0,1,4,2,2,4,9,13,0,Matches
62,Wissam Ben Yedder,fr FRA,FW,es Sevilla,26,1990,7.2,3,2,0,2,1,2,4,50.0,2,2,0,2,2,5,2,0,Matches
63,Diego Benaglio,ch SUI,GK,fr Monaco,33,1983,3.0,0,0,0,0,0,0,0,,0,0,0,0,0,0,1,0,Matches
64,Medhi Benatia,ma MAR,DF,it Juventus,30,1987,6.3,4,4,2,2,0,1,4,25.0,3,4,0,4,21,25,35,0,Matches
65,Rodrigo Bentancur,uy URU,"MF,FW",it Juventus,20,1997,3.2,6,5,1,3,2,3,12,25.0,9,5,1,4,9,15,6,0,Matches
66,Karim Benzema,fr FRA,FW,es Real Madrid,29,1987,6.7,5,5,0,4,1,1,5,20.0,4,1,0,1,1,6,8,0,Matches
67,Yuri Berchiche,es ESP,DF,fr Paris S-G,27,1990,2.0,6,6,4,1,1,3,3,100.0,0,2,2,0,2,8,7,0,Matches
68,Aleksei Berezutski,ru RUS,DF,ru CSKA Moscow,35,1982,3.0,6,5,5,1,0,5,9,55.6,4,4,0,4,5,11,22,0,Matches
69,Vasili Berezutski,ru RUS,DF,ru CSKA Moscow,35,1982,5.0,4,3,4,0,0,1,8,12.5,7,4,3,1,9,13,35,1,Matches
70,Steven Berghuis,nl NED,FW,nl Feyenoord,25,1991,5.2,10,6,3,6,1,1,6,16.7,5,8,0,8,4,14,1,0,Matches
71,Bernard,br BRA,FW,ua Shakhtar,24,1992,7.6,11,8,7,4,0,5,20,25.0,15,12,0,12,14,25,5,1,Matches
72,Federico Bernardeschi,it ITA,FW,it Juventus,23,1994,1.5,4,3,4,0,0,2,4,50.0,2,1,0,1,0,4,2,0,Matches
73,Bernardo,br BRA,DF,de RB Leipzig,22,1995,1.3,4,1,2,1,1,2,4,50.0,2,3,0,3,0,4,3,0,Matches
74,Juan Bernat,es ESP,DF,de Bayern Munich,24,1993,0.5,1,0,1,0,0,1,1,100.0,0,0,0,0,0,1,2,0,Matches
75,Jean-Claude Billong,cm CMR,DF,si NK Maribor,23,1993,4.0,6,4,5,1,0,2,7,28.6,5,5,5,0,6,12,34,0,Matches
76,Nir Bitton,il ISR,"DF,MF",sct Celtic,25,1991,2.1,11,6,7,3,1,7,9,77.8,2,1,0,1,5,16,7,0,Matches
77,Daley Blind,nl NED,DF,eng Manchester Utd,27,1990,6.0,13,8,8,3,2,3,11,27.3,8,8,1,7,13,26,23,0,Matches
78,Jérôme Boateng,de GER,DF,de Bayern Munich,28,1988,7.5,3,3,2,1,0,2,5,40.0,3,8,4,4,9,12,22,1,Matches
79,Salvatore Bocchetti,it ITA,DF,ru Spartak Moscow,30,1986,3.0,6,5,4,2,0,2,7,28.6,5,6,4,2,14,20,15,1,Matches
80,Frank Boeckx,be BEL,GK,be Anderlecht,30,1986,3.0,0,0,0,0,0,0,0,,0,1,0,1,1,1,0,0,Matches
81,Jean-Paul Boëtius,nl NED,FW,nl Feyenoord,23,1994,5.8,13,8,4,7,2,0,5,0.0,5,11,0,11,5,18,1,0,Matches
82,Damjan Bohar,si SVN,"MF,FW",si NK Maribor,25,1991,5.4,10,6,7,3,0,4,13,30.8,9,1,0,1,6,16,13,2,Matches
83,Gabriel Boschilia,br BRA,DF,fr Monaco,21,1996,0.1,0,0,0,0,0,0,0,,0,0,0,0,0,0,0,0,Matches
84,Alberto Botía,es ESP,DF,gr Olympiacos,28,1989,3.0,3,2,3,0,0,3,7,42.9,4,8,7,1,5,8,24,0,Matches
85,Eric Botteghin,br BRA,DF,nl Feyenoord,29,1987,1.0,0,0,0,0,0,0,2,0.0,2,1,1,0,2,2,7,0,Matches
86,Dedryck Boyata,be BEL,DF,sct Celtic,26,1990,5.0,6,6,6,0,0,1,4,25.0,3,8,4,4,12,18,37,1,Matches
87,Yacine Brahimi,dz ALG,"FW,MF",pt Porto,27,1990,6.3,13,9,5,7,1,5,8,62.5,3,9,0,9,5,18,1,0,Matches
88,Claudio Bravo,cl CHI,GK,eng Manchester City,34,1983,1.0,0,0,0,0,0,0,0,,0,0,0,0,1,1,0,0,Matches
89,Scott Brown,sct SCO,MF,sct Celtic,32,1985,5.8,13,3,6,7,0,3,15,20.0,12,8,2,6,12,25,9,0,Matches
90,Bruma,pt POR,"FW,MF",de RB Leipzig,22,1994,3.0,3,2,0,3,0,2,3,66.7,1,0,0,0,2,5,0,0,Matches
91,Massimo Bruno,be BEL,FW,be Anderlecht,23,1993,0.5,1,1,0,1,0,0,0,,0,0,0,0,1,2,0,1,Matches
92,Kevin Bua,ch SUI,"MF,FW",ch Basel,23,1993,1.1,3,2,0,1,2,0,3,0.0,3,0,0,0,0,3,1,0,Matches
93,Gianluigi Buffon,it ITA,GK,it Juventus,39,1978,9.0,0,0,0,0,0,0,3,0.0,3,0,0,0,0,0,2,1,Matches
94,Roman Bürki,ch SUI,GK,de Dortmund,26,1990,6.0,0,0,0,0,0,0,1,0.0,1,0,0,0,0,0,3,2,Matches
95,Sergio Busquets,es ESP,MF,es Barcelona,29,1988,8.5,23,17,7,14,2,10,28,35.7,18,13,4,9,5,28,8,0,Matches
96,Bohdan Butko,ua UKR,DF,ua Shakhtar,26,1991,7.0,13,9,11,2,0,6,16,37.5,10,7,2,5,10,23,41,1,Matches
97,Gary Cahill,eng ENG,DF,eng Chelsea,31,1985,5.0,5,4,5,0,0,1,3,33.3,2,4,2,2,6,11,15,0,Matches
98,Fabrizio Caligara,it ITA,FW,it Juventus,17,2000,0.0,0,0,0,0,0,0,0,,0,0,0,0,0,0,0,0,Matches
99,José Callejón,es ESP,FW,it Napoli,30,1987,5.6,6,3,2,3,1,2,14,14.3,12,7,1,6,4,10,4,0,Matches
100,Igor de Camargo,be BEL,FW,cy APOEL FC,34,1983,2.6,3,0,2,1,0,0,1,0.0,1,2,0,2,4,7,5,0,Matches
101,Emre Can,de GER,MF,eng Liverpool,23,1994,5.9,13,9,5,7,1,1,10,10.0,9,14,1,13,7,20,3,0,Matches
102,Mehdi Carcela,ma MAR,"FW,MF",gr Olympiacos,28,1989,3.0,10,5,3,7,0,1,4,25.0,3,2,0,2,3,13,0,0,Matches
103,Carlão,br BRA,DF,cy APOEL FC,31,1986,5.0,7,6,5,2,0,1,2,50.0,1,13,12,1,16,23,19,1,Matches
104,Yannick Carrasco,be BEL,"MF,FW",es Atlético Madrid,23,1993,3.0,4,2,0,3,1,2,6,33.3,4,4,1,3,3,7,0,1,Matches
105,Guido Carrillo,ar ARG,FW,fr Monaco,26,1991,1.5,3,2,0,2,1,1,1,100.0,0,3,2,1,1,4,1,0,Matches
106,Dani Carvajal,es ESP,DF,es Real Madrid,25,1992,7.2,23,15,11,7,5,9,14,64.3,5,13,5,8,17,40,14,0,Matches
107,João Carvalho,pt POR,MF,pt Benfica,20,1997,1.0,0,0,0,0,0,0,1,0.0,1,1,0,1,4,4,0,0,Matches
108,William Carvalho,pt POR,MF,pt Sporting CP,25,1992,5.0,11,8,3,8,0,3,10,30.0,7,2,1,1,5,16,4,0,Matches
109,Casemiro,br BRA,MF,es Real Madrid,25,1992,10.5,45,29,25,14,6,21,45,46.7,24,31,11,20,23,68,25,1,Matches
110,Kiko Casilla,es ESP,GK,es Real Madrid,30,1986,2.0,0,0,0,0,0,0,0,,0,0,0,0,0,0,1,0,Matches
111,Iker Casillas,es ESP,GK,pt Porto,36,1981,3.0,0,0,0,0,0,0,0,,0,0,0,0,0,0,0,0,Matches
112,Gonzalo Castro,de GER,MF,de Dortmund,30,1987,1.5,6,3,1,3,2,0,1,0.0,1,0,0,0,2,8,0,0,Matches
113,Edinson Cavani,uy URU,FW,fr Paris S-G,30,1987,7.6,1,1,0,1,0,0,5,0.0,5,1,1,0,5,6,6,0,Matches
114,Dani Ceballos,es ESP,"MF,FW",es Real Madrid,20,1996,0.9,2,1,1,1,0,1,5,20.0,4,2,0,2,2,4,0,0,Matches
115,Franco Cervi,ar ARG,"MF,FW",pt Benfica,23,1994,1.1,2,2,2,0,0,0,1,0.0,1,3,0,3,0,2,1,0,Matches
116,Bruno César,br BRA,"MF,FW",pt Sporting CP,28,1988,2.8,2,2,0,1,1,1,3,33.3,2,5,2,3,4,6,0,0,Matches
117,Júlio César,br BRA,GK,pt Benfica,37,1979,1.0,0,0,0,0,0,0,0,,0,0,0,0,0,0,0,0,Matches
118,Fyodor Chalov,ru RUS,FW,ru CSKA Moscow,19,1998,1.6,0,0,0,0,0,0,3,0.0,3,0,0,0,1,1,2,0,Matches
119,Giorgio Chiellini,it ITA,DF,it Juventus,32,1984,7.0,15,10,8,5,2,3,8,37.5,5,8,3,5,13,28,46,0,Matches
120,Alexandru Chipciu,ro ROU,DF,be Anderlecht,28,1989,2.0,8,6,7,0,1,5,9,55.6,4,1,0,1,6,14,2,0,Matches
121,Vlad Chiricheș,ro ROU,DF,it Napoli,27,1989,1.0,1,1,1,0,0,1,2,50.0,1,1,0,1,1,2,1,0,Matches
122,Andreas Christensen,dk DEN,DF,eng Chelsea,21,1996,5.0,5,3,4,1,0,3,6,50.0,3,4,1,3,8,13,22,1,Matches
123,Jasper Cillessen,nl NED,GK,es Barcelona,28,1989,1.0,0,0,0,0,0,0,0,,0,0,0,0,0,0,1,0,Matches
124,Orkan Çınar,tr TUR,FW,tr Beşiktaş,21,1996,0.2,1,1,1,0,0,1,2,50.0,1,0,0,0,0,1,0,0,Matches
125,Nathaniel Clyne,eng ENG,DF,eng Liverpool,26,1991,0.1,1,1,1,0,0,0,0,,0,0,0,0,0,1,1,0,Matches
126,Sebastián Coates,uy URU,DF,pt Sporting CP,26,1990,5.0,12,9,10,2,0,6,12,50.0,6,10,7,3,14,26,19,0,Matches
127,Fábio Coentrão,pt POR,"DF,MF",pt Sporting CP,29,1988,3.0,4,2,1,2,1,3,6,50.0,3,3,1,2,6,10,11,0,Matches
128,Kingsley Coman,fr FRA,"FW,MF",de Bayern Munich,21,1996,4.3,6,4,1,4,1,0,2,0.0,2,4,0,4,1,7,0,0,Matches
129,Marvin Compper,de GER,DF,de RB Leipzig,32,1985,0.2,0,0,0,0,0,0,0,,0,0,0,0,1,1,0,0,Matches
130,Sébastien Corchia,fr FRA,DF,es Sevilla,26,1990,1.2,2,2,0,1,1,2,3,66.7,1,0,0,0,2,4,2,0,Matches
131,Jesús Corona,mx MEX,MF,pt Porto,24,1993,3.5,12,9,7,5,0,4,14,28.6,10,5,0,5,7,19,0,0,Matches
132,Ángel Correa,ar ARG,"MF,FW",es Atlético Madrid,22,1995,2.8,2,0,1,0,1,0,6,0.0,6,3,0,3,3,5,2,0,Matches
133,Joaquín Correa,ar ARG,FW,es Sevilla,22,1994,7.0,13,7,2,8,3,2,13,15.4,11,4,0,4,7,20,3,0,Matches
134,Douglas Costa,br BRA,"FW,MF",it Juventus,26,1990,8.0,6,1,3,3,0,1,14,7.1,13,7,0,7,8,14,3,0,Matches
135,Thibaut Courtois,be BEL,GK,eng Chelsea,25,1992,8.0,0,0,0,0,0,0,0,,0,0,0,0,2,2,0,1,Matches
136,Philippe Coutinho,br BRA,"MF,FW",eng Liverpool,25,1992,3.9,3,0,1,2,0,1,3,33.3,2,3,1,2,4,7,2,0,Matches
137,Juan Cuadrado,co COL,FW,it Juventus,29,1988,4.6,17,10,7,7,3,6,13,46.2,7,2,0,2,5,22,5,1,Matches
138,Mahmoud Dahoud,de GER,MF,de Dortmund,21,1996,2.1,5,2,3,1,1,1,2,50.0,1,3,0,3,2,7,3,1,Matches
139,Diogo Dalot,pt POR,DF,pt Porto,18,1999,1.0,1,0,1,0,0,0,1,0.0,1,1,0,1,2,3,7,0,Matches
140,Danilo,br BRA,DF,eng Manchester City,26,1991,4.1,12,9,5,6,1,7,10,70.0,3,7,1,6,7,19,13,0,Matches
141,Matteo Darmian,it ITA,DF,eng Manchester Utd,27,1989,2.3,8,5,5,3,0,2,2,100.0,0,2,1,1,5,13,5,0,Matches
142,Ben Davies,wls WAL,DF,eng Tottenham,24,1993,5.0,8,6,4,3,1,4,10,40.0,6,8,1,7,6,14,23,0,Matches
143,Kevin De Bruyne,be BEL,MF,eng Manchester City,26,1991,7.4,13,9,2,9,2,7,22,31.8,15,6,2,4,12,25,2,0,Matches
144,Daniele De Rossi,it ITA,MF,it Roma,34,1983,8.6,14,10,8,6,0,7,22,31.8,15,13,3,10,14,28,13,0,Matches
145,Mattia De Sciglio,it ITA,DF,it Juventus,24,1992,4.4,7,3,5,2,0,6,7,85.7,1,4,2,2,1,8,18,1,Matches
146,Grégoire Defrel,mq MTQ,FW,it Roma,26,1991,1.8,3,2,1,1,1,0,0,,0,1,0,1,1,4,1,1,Matches
147,Fabian Delph,eng ENG,DF,eng Manchester City,27,1989,4.3,10,8,3,7,0,6,14,42.9,8,3,0,3,8,18,15,0,Matches
148,Mousa Dembélé,be BEL,MF,eng Tottenham,30,1987,3.6,10,6,1,6,3,2,5,40.0,3,4,1,3,6,16,1,0,Matches
149,Moussa Dembélé,fr FRA,FW,sct Celtic,21,1996,3.0,3,3,0,3,0,0,0,,0,1,0,1,1,4,2,0,Matches
150,Ousmane Dembélé,fr FRA,"MF,FW",es Barcelona,20,1997,1.6,1,1,0,1,0,0,6,0.0,6,1,0,1,2,3,1,0,Matches
151,Diego Demme,de GER,MF,de RB Leipzig,25,1991,3.6,10,8,3,6,1,4,14,28.6,10,3,0,3,6,16,7,0,Matches
152,Leander Dendoncker,be BEL,"MF,DF",be Anderlecht,22,1995,6.0,9,2,4,5,0,5,14,35.7,9,4,1,3,15,24,4,2,Matches
153,Dentinho,br BRA,"MF,FW",ua Shakhtar,28,1989,0.4,1,0,0,0,1,1,1,100.0,0,0,0,0,0,1,0,0,Matches
154,Jan-Arie van der Heijden,nl NED,DF,nl Feyenoord,29,1988,1.0,0,0,0,0,0,0,0,,0,2,2,0,0,0,4,0,Matches
155,Olivier Deschacht,be BEL,DF,be Anderlecht,36,1981,3.6,3,3,2,1,0,2,3,66.7,1,4,2,2,3,6,11,1,Matches
156,Gerard Deulofeu,es ESP,"FW,MF",es Barcelona,23,1994,1.6,0,0,0,0,0,0,5,0.0,5,0,0,0,2,2,0,0,Matches
157,Ángel Di María,ar ARG,FW,fr Paris S-G,29,1988,1.6,1,1,1,0,0,1,2,50.0,1,1,0,1,0,1,0,0,Matches
158,Adama Diakhaby,fr FRA,FW,fr Monaco,21,1996,2.5,7,4,4,3,0,3,5,60.0,2,4,0,4,2,9,2,0,Matches
159,Lassana Diarra,fr FRA,MF,fr Paris S-G,32,1985,0.1,0,0,0,0,0,0,0,,0,0,0,0,1,1,0,0,Matches
160,Rúben Dias,pt POR,DF,pt Benfica,20,1997,2.0,4,3,3,1,0,1,2,50.0,1,2,2,0,1,5,13,0,Matches
161,Amadou Diawara,gn GUI,MF,it Napoli,20,1997,4.1,5,2,2,2,1,1,6,16.7,5,7,1,6,7,12,3,0,Matches
162,Brahim Díaz,ma MAR,"MF,FW",eng Manchester City,17,1999,0.6,0,0,0,0,0,0,0,,0,0,0,0,0,0,0,0,Matches
163,Serey Die,ci CIV,MF,ch Basel,32,1984,3.2,10,5,3,5,2,7,18,38.9,11,6,1,5,7,17,0,0,Matches
164,Eric Dier,eng ENG,"MF,DF",eng Tottenham,23,1994,6.8,14,9,6,6,2,5,10,50.0,5,8,4,4,5,19,23,1,Matches
165,Lucas Digne,fr FRA,DF,es Barcelona,24,1993,3.0,8,4,3,2,3,2,3,66.7,1,3,0,3,6,14,7,0,Matches
166,Kevin Diks,id IDN,DF,nl Feyenoord,20,1996,2.0,6,4,5,1,0,4,5,80.0,1,2,0,2,5,11,4,1,Matches
167,Joshgun Diniyev,az AZE,MF,az Qarabağ,21,1995,0.7,0,0,0,0,0,0,2,0.0,2,0,0,0,0,0,0,0,Matches
168,Bas Dost,nl NED,FW,pt Sporting CP,28,1989,4.2,3,0,3,0,0,0,0,,0,1,0,1,1,4,3,0,Matches
169,Douglas,br BRA,DF,pt Benfica,26,1990,3.0,10,6,8,1,1,7,13,53.8,6,0,0,0,5,15,2,1,Matches
170,Seydou Doumbia,ci CIV,FW,pt Sporting CP,29,1987,1.3,0,0,0,0,0,0,1,0.0,1,0,0,0,0,0,0,0,Matches
171,Julian Draxler,de GER,MF,fr Paris S-G,23,1993,3.5,6,4,2,2,2,1,7,14.3,6,2,1,1,6,12,2,0,Matches
172,Danny Drinkwater,eng ENG,MF,eng Chelsea,27,1990,0.4,1,0,0,1,0,0,1,0.0,1,1,0,1,0,1,1,0,Matches
173,Paulo Dybala,ar ARG,"MF,FW",it Juventus,23,1993,7.3,4,3,0,4,0,1,9,11.1,8,7,0,7,0,4,1,0,Matches
174,Alan Dzagoev,ru RUS,"MF,FW",ru CSKA Moscow,27,1990,4.1,3,0,2,0,1,1,12,8.3,11,7,0,7,1,4,5,0,Matches
175,Edin Džeko,ba BIH,FW,it Roma,31,1986,12.0,6,5,0,3,3,0,4,0.0,4,2,0,2,0,6,9,1,Matches
176,Georgi Dzhikiya,ru RUS,DF,ru Spartak Moscow,23,1993,4.7,8,6,4,3,1,5,5,100.0,0,2,2,0,10,18,30,0,Matches
177,Lorenzo Ebecilio,nl NED,"MF,FW",cy APOEL FC,25,1991,2.9,5,2,4,0,1,1,3,33.3,2,2,0,2,2,7,3,0,Matches
178,Ederson,br BRA,GK,eng Manchester City,23,1993,9.0,0,0,0,0,0,0,3,0.0,3,0,0,0,1,1,5,0,Matches
179,Odsonne Édouard,fr FRA,FW,sct Celtic,19,1998,0.4,0,0,0,0,0,0,2,0.0,2,1,0,1,0,0,1,0,Matches
180,Giorgos Efrem,cy CYP,MF,cy APOEL FC,28,1989,0.3,0,0,0,0,0,0,0,,0,2,0,2,0,0,0,0,Matches
181,Omar Elabdellaoui,no NOR,DF,gr Olympiacos,25,1991,4.0,3,3,3,0,0,2,3,66.7,1,3,0,3,12,15,13,0,Matches
182,Eliseu,pt POR,DF,pt Benfica,33,1983,2.2,1,1,1,0,0,0,1,0.0,1,2,0,2,4,5,3,0,Matches
183,Mohamed Elyounoussi,no NOR,"FW,MF",ch Basel,22,1994,7.1,3,2,2,1,0,0,15,0.0,15,14,5,9,7,10,6,0,Matches
184,Tarik Elyounoussi,no NOR,"FW,MF",az Qarabağ,29,1988,0.4,1,1,1,0,0,1,1,100.0,0,1,0,1,2,3,0,0,Matches
185,Emmanuel Emenike,ng NGA,FW,gr Olympiacos,30,1987,1.3,0,0,0,0,0,0,0,,0,0,0,0,0,0,1,0,Matches
186,Björn Engels,be BEL,DF,gr Olympiacos,22,1994,5.0,4,2,2,2,0,2,5,40.0,3,7,6,1,4,8,30,1,Matches
187,Christian Eriksen,dk DEN,"MF,FW",eng Tottenham,25,1992,5.9,5,3,0,3,2,1,7,14.3,6,7,2,5,4,9,2,0,Matches
188,Caner Erkin,tr TUR,DF,tr Beşiktaş,28,1988,5.8,7,2,4,3,0,4,19,21.1,15,2,0,2,21,28,14,0,Matches
189,Sergio Escudero,es ESP,DF,es Sevilla,27,1989,10.0,21,12,11,7,3,9,19,47.4,10,6,2,4,19,40,39,0,Matches
190,Fabinho,br BRA,MF,fr Monaco,23,1993,5.0,18,7,8,7,3,7,11,63.6,4,6,0,6,8,26,5,0,Matches
191,Cesc Fàbregas,es ESP,MF,eng Chelsea,30,1987,7.7,19,12,10,3,6,6,22,27.3,16,11,1,10,14,33,4,0,Matches
192,Fabricio,es ESP,GK,tr Beşiktaş,29,1987,6.0,0,0,0,0,0,0,0,,0,0,0,0,0,0,6,0,Matches
193,Radamel Falcao,co COL,FW,fr Monaco,31,1986,4.3,5,4,3,1,1,1,1,100.0,0,3,2,1,2,7,4,0,Matches
194,Agustín Farías,ar ARG,"MF,FW",cy APOEL FC,29,1987,0.9,7,4,5,0,2,3,8,37.5,5,2,1,1,2,9,3,0,Matches
195,Federico Fazio,ar ARG,DF,it Roma,30,1987,10.2,21,11,13,8,0,10,18,55.6,8,17,12,5,21,42,45,1,Matches
196,Ljubomir Fejsa,rs SRB,MF,pt Benfica,28,1988,4.0,7,5,1,6,0,2,6,33.3,4,4,1,3,6,13,6,0,Matches
197,Felipe,br BRA,DF,pt Porto,28,1989,6.4,11,6,10,1,0,3,10,30.0,7,12,8,4,22,33,39,0,Matches
198,Marouane Fellaini,be BEL,MF,eng Manchester Utd,29,1987,2.5,3,3,0,3,0,0,3,0.0,3,0,0,0,2,5,6,0,Matches
199,Bruno Fernandes,pt POR,MF,pt Sporting CP,22,1994,6.0,15,7,6,7,2,5,16,31.3,11,6,1,5,4,19,1,1,Matches
200,Mário Fernandes,ru RUS,"FW,MF",ru CSKA Moscow,26,1990,6.0,14,10,3,9,2,5,11,45.5,6,3,1,2,7,21,27,0,Matches
201,Augusto Fernández,ar ARG,MF,es Atlético Madrid,31,1986,0.6,0,0,0,0,0,0,2,0.0,2,1,1,0,2,2,0,0,Matches
202,Fernandinho,br BRA,"MF,DF",eng Manchester City,32,1985,7.6,17,10,8,8,1,10,30,33.3,20,9,1,8,14,31,19,1,Matches
203,Fernando,br BRA,MF,ru Spartak Moscow,25,1992,6.0,7,5,3,3,1,2,15,13.3,13,7,0,7,12,19,9,1,Matches
204,Facundo Ferreyra,ar ARG,FW,ua Shakhtar,26,1991,7.8,6,2,1,4,1,0,1,0.0,1,8,1,7,1,7,4,0,Matches
205,Diogo Figueiras,pt POR,"DF,MF",gr Olympiacos,26,1991,4.0,7,3,4,3,0,2,4,50.0,2,2,1,1,13,20,14,0,Matches
206,Tobias Figueiredo,pt POR,DF,pt Sporting CP,23,1994,0.1,0,0,0,0,0,0,0,,0,0,0,0,0,0,1,0,Matches
207,Roberto Firmino,br BRA,FW,eng Liverpool,25,1991,11.7,23,17,3,15,5,0,20,0.0,20,11,1,10,3,26,5,0,Matches
208,Alessandro Florenzi,it ITA,"DF,FW",it Roma,26,1991,7.9,12,9,10,1,1,8,23,34.8,15,8,0,8,17,29,10,0,Matches
209,Phil Foden,eng ENG,"MF,DF",eng Manchester City,17,2000,2.2,2,1,0,2,0,1,7,14.3,6,0,0,0,0,2,1,0,Matches
210,James Forrest,sct SCO,"DF,FW",sct Celtic,26,1991,3.4,4,1,1,3,0,2,6,33.3,4,1,0,1,2,6,4,0,Matches
211,Emil Forsberg,se SWE,"MF,FW",de RB Leipzig,25,1991,4.6,5,4,0,4,1,0,4,0.0,4,5,0,5,1,6,2,0,Matches
212,Hernâni Fortes,pt POR,MF,pt Porto,25,1991,0.2,0,0,0,0,0,0,2,0.0,2,0,0,0,0,0,0,0,Matches
213,Kostas Fortounis,gr GRE,"FW,MF",gr Olympiacos,24,1992,2.7,2,2,0,2,0,0,1,0.0,1,0,0,0,0,2,0,0,Matches
214,Juan Foyth,ar ARG,DF,eng Tottenham,19,1998,1.0,2,0,2,0,0,0,0,,0,2,1,1,1,3,2,0,Matches
215,Alexander Fransson,se SWE,MF,ch Basel,23,1994,0.1,0,0,0,0,0,0,0,,0,0,0,0,0,0,0,0,Matches
216,Fred,br BRA,MF,ua Shakhtar,24,1993,8.0,23,16,11,10,2,8,26,30.8,18,15,3,12,9,32,6,1,Matches
217,Fabian Frei,ch SUI,"DF,MF",ch Basel,28,1989,2.0,1,1,0,1,0,0,2,0.0,2,1,0,1,8,9,8,0,Matches
218,Marco Friedl,at AUT,DF,de Bayern Munich,19,1998,1.0,1,1,1,0,0,1,2,50.0,1,2,0,2,3,4,4,0,Matches
219,Gabi,es ESP,MF,es Atlético Madrid,34,1983,3.9,7,2,2,3,2,4,13,30.8,9,5,1,4,2,9,4,0,Matches
220,Nicolás Gaitán,ar ARG,MF,es Atlético Madrid,29,1988,1.4,5,2,3,1,1,2,5,40.0,3,1,0,1,5,10,0,0,Matches
221,Cristian Gamboa,cr CRC,DF,sct Celtic,27,1989,1.0,3,2,3,0,0,3,5,60.0,2,2,1,1,3,6,3,0,Matches
222,Kévin Gameiro,fr FRA,FW,es Atlético Madrid,30,1987,1.8,0,0,0,0,0,0,3,0.0,3,2,1,1,2,2,0,0,Matches
223,Ganso,br BRA,MF,es Sevilla,27,1989,0.3,1,1,0,1,0,0,2,0.0,2,1,0,1,0,1,0,0,Matches
224,Gara Garayev,az AZE,MF,az Qarabağ,24,1992,5.8,10,8,7,3,0,4,14,28.6,10,7,2,5,8,18,9,0,Matches
225,David de Gea,es ESP,GK,eng Manchester Utd,26,1990,6.0,0,0,0,0,0,0,0,,0,0,0,0,0,0,0,0,Matches
226,Johannes Geis,de GER,DF,es Sevilla,23,1993,1.0,1,1,1,0,0,1,2,50.0,1,1,1,0,0,1,3,0,Matches
227,Anthony Georgiou,cy CYP,MF,eng Tottenham,20,1997,0.1,0,0,0,0,0,0,0,,0,1,0,1,0,0,0,0,Matches
228,Pieter Gerkens,be BEL,"FW,MF",be Anderlecht,21,1995,4.5,8,5,0,7,1,2,10,20.0,8,4,0,4,3,11,0,0,Matches
229,Gerson,br BRA,FW,it Roma,20,1997,2.4,9,5,3,3,3,3,5,60.0,2,5,1,4,2,11,1,0,Matches
230,Rachid Ghezzal,dz ALG,"MF,FW",fr Monaco,25,1992,1.6,3,0,2,0,1,1,3,33.3,2,1,0,1,3,6,0,0,Matches
231,Faouzi Ghoulam,dz ALG,DF,it Napoli,26,1991,3.3,5,4,2,2,1,3,7,42.9,4,3,1,2,5,10,3,0,Matches
232,Guillaume Gillet,be BEL,MF,gr Olympiacos,33,1984,2.8,8,4,2,6,0,1,4,25.0,3,3,0,3,5,13,3,0,Matches
233,Olivier Giroud,fr FRA,FW,eng Chelsea,30,1986,0.7,0,0,0,0,0,0,1,0.0,1,0,0,0,0,0,1,0,Matches
234,Kamil Glik,pl POL,DF,fr Monaco,29,1988,6.0,10,9,8,2,0,5,8,62.5,3,4,1,3,4,14,31,0,Matches
235,Denis Glushakov,ru RUS,MF,ru Spartak Moscow,30,1987,3.7,6,2,3,3,0,3,11,27.3,8,5,1,4,4,10,4,0,Matches
236,Diego Godín,uy URU,DF,es Atlético Madrid,31,1986,4.0,9,7,6,3,0,5,11,45.5,6,1,0,1,8,17,11,0,Matches
237,Aleksandr Golovin,ru RUS,MF,ru CSKA Moscow,21,1996,6.0,13,9,5,6,2,5,23,21.7,18,5,1,4,10,23,2,0,Matches
238,André Gomes,pt POR,MF,es Barcelona,24,1993,1.9,8,7,1,6,1,3,6,50.0,3,0,0,0,2,10,2,0,Matches
239,Joe Gomez,eng ENG,DF,eng Liverpool,20,1997,4.1,10,7,6,4,0,2,8,25.0,6,10,1,9,12,22,14,0,Matches
240,Maxime Gonalons,fr FRA,MF,it Roma,28,1989,3.4,9,6,5,3,1,1,8,12.5,7,4,0,4,7,16,3,2,Matches
241,Diogo Gonçalves,pt POR,"FW,MF",pt Benfica,20,1997,3.0,0,0,0,0,0,0,2,0.0,2,2,0,2,0,0,0,0,Matches
242,Gökhan Gönül,tr TUR,DF,tr Beşiktaş,32,1985,3.2,13,10,8,4,1,6,10,60.0,4,2,0,2,14,27,11,0,Matches
243,Craig Gordon,sct SCO,GK,sct Celtic,34,1982,6.0,0,0,0,0,0,0,1,0.0,1,0,0,0,1,1,1,1,Matches
244,Astemir Gordyushenko,ru RUS,FW,ru CSKA Moscow,20,1997,0.3,4,2,2,1,1,0,3,0.0,3,1,0,1,0,4,1,0,Matches
245,Mario Götze,de GER,MF,de Dortmund,25,1992,4.1,9,6,4,4,1,2,13,15.4,11,5,0,5,2,11,1,0,Matches
246,Antoine Griezmann,fr FRA,FW,es Atlético Madrid,26,1991,5.9,6,4,1,5,0,1,1,100.0,0,4,0,4,2,8,2,0,Matches
247,Leigh Griffiths,sct SCO,FW,sct Celtic,26,1990,2.8,3,2,0,3,0,0,4,0.0,4,5,0,5,2,5,1,0,Matches
248,Álex Grimaldo,es ESP,DF,pt Benfica,21,1995,3.6,7,3,4,2,1,6,13,46.2,7,5,0,5,5,12,3,0,Matches
249,Marko Grujić,rs SRB,FW,eng Liverpool,21,1996,0.1,0,0,0,0,0,0,0,,0,0,0,0,0,0,0,0,Matches
250,Raúl Gudiño,mx MEX,GK,cy APOEL FC,21,1996,0.5,0,0,0,0,0,0,0,,0,0,0,0,0,0,0,0,Matches
251,Raphaël Guerreiro,pt POR,"MF,DF",de Dortmund,23,1993,2.8,1,0,1,0,0,0,2,0.0,2,3,0,3,4,5,2,0,Matches
252,Wilde-Donald Guerrier,ht HAI,"DF,MF",az Qarabağ,28,1989,3.9,8,7,6,1,1,3,6,50.0,3,2,0,2,4,12,9,0,Matches
253,Péter Gulácsi,hu HUN,GK,de RB Leipzig,27,1990,6.0,0,0,0,0,0,0,0,,0,0,0,0,0,0,2,1,Matches
254,İlkay Gündoğan,de GER,MF,eng Manchester City,26,1990,5.6,16,11,5,9,2,3,12,25.0,9,0,0,0,8,24,2,0,Matches
255,Achraf Hakimi,ma MAR,DF,es Real Madrid,18,1998,2.0,3,3,0,2,1,2,3,66.7,1,3,0,3,1,4,3,0,Matches
256,Marcel Halstenberg,de GER,DF,de RB Leipzig,25,1991,5.2,16,15,9,6,1,6,14,42.9,8,3,1,2,9,25,11,0,Matches
257,Marek Hamšík,sk SVK,MF,it Napoli,30,1987,5.2,8,5,0,7,1,1,11,9.1,10,4,0,4,5,13,5,2,Matches
258,Jasmin Handanović,si SVN,GK,si NK Maribor,39,1978,6.0,0,0,0,0,0,0,0,,0,0,0,0,0,0,7,2,Matches
259,Sofiane Hanni,dz ALG,"FW,MF",be Anderlecht,26,1990,5.2,3,3,0,2,1,0,3,0.0,3,9,0,9,10,13,4,0,Matches
260,Ridgeciano Haps,sr SUR,DF,nl Feyenoord,24,1993,4.0,10,8,7,3,0,3,5,60.0,2,4,1,3,13,23,11,0,Matches
261,Hamdi Harbaoui,tn TUN,FW,be Anderlecht,32,1985,0.2,0,0,0,0,0,0,0,,0,0,0,0,1,1,0,0,Matches
262,Eden Hazard,be BEL,"FW,MF",eng Chelsea,26,1991,6.8,2,2,0,1,1,0,2,0.0,2,3,0,3,1,3,2,0,Matches
263,Jordan Henderson,eng ENG,MF,eng Liverpool,27,1990,9.6,24,14,6,16,2,7,23,30.4,16,17,5,12,16,40,12,0,Matches
264,Pedro Henrique,br BRA,"FW,MF",az Qarabağ,27,1990,3.1,6,5,1,4,1,1,8,12.5,7,2,0,2,1,7,5,0,Matches
265,Lucas Hernández,fr FRA,DF,es Atlético Madrid,21,1996,3.0,1,1,1,0,0,0,1,0.0,1,5,1,4,7,8,8,0,Matches
266,Theo Hernández,fr FRA,DF,es Real Madrid,19,1997,1.5,3,2,1,1,1,3,6,50.0,3,0,0,0,1,4,1,0,Matches
267,Ander Herrera,es ESP,MF,eng Manchester Utd,27,1989,4.2,13,10,6,7,0,1,12,8.3,11,8,1,7,12,25,7,0,Matches
268,Héctor Herrera,mx MEX,MF,pt Porto,27,1990,5.9,19,15,5,13,1,3,19,15.8,16,9,1,8,8,27,2,0,Matches
269,Son Heung-min,kr KOR,"FW,MF",eng Tottenham,25,1992,4.7,7,5,3,3,1,2,11,18.2,9,4,0,4,0,7,2,0,Matches
270,Gonzalo Higuaín,ar ARG,FW,it Juventus,29,1987,9.2,10,4,0,6,4,1,6,16.7,5,5,0,5,4,14,7,1,Matches
271,Dino Hotić,ba BIH,"MF,FW",si NK Maribor,22,1995,1.7,1,0,0,1,0,0,2,0.0,2,2,0,2,1,2,1,0,Matches
272,Mats Hummels,de GER,DF,de Bayern Munich,28,1988,7.5,18,12,14,4,0,6,13,46.2,7,7,2,5,10,28,27,0,Matches
273,Badavi Huseynov,az AZE,DF,az Qarabağ,26,1991,3.0,5,5,4,1,0,3,5,60.0,2,4,2,2,8,13,13,0,Matches
274,Atiba Hutchinson,ca CAN,MF,tr Beşiktaş,34,1983,6.3,19,11,10,7,2,7,16,43.8,9,7,4,3,12,31,9,0,Matches
275,Elseid Hysaj,al ALB,DF,it Napoli,23,1994,5.8,14,10,9,4,1,5,12,41.7,7,3,1,2,14,28,15,0,Matches
276,Zlatan Ibrahimović,se SWE,FW,eng Manchester Utd,35,1981,0.2,0,0,0,0,0,0,0,,0,0,0,0,0,0,0,0,Matches
277,Sergei Ignashevich,ru RUS,DF,ru CSKA Moscow,38,1979,3.5,5,2,1,4,0,2,5,40.0,3,5,3,2,11,16,15,0,Matches
278,Stefan Ilsanker,at AUT,"DF,MF",de RB Leipzig,28,1989,2.9,12,7,3,8,1,6,7,85.7,1,1,1,0,6,18,16,0,Matches
279,Danny Ings,eng ENG,FW,eng Liverpool,25,1992,0.6,3,2,0,2,1,1,1,100.0,0,3,0,3,1,4,0,0,Matches
280,Andrés Iniesta,es ESP,MF,es Barcelona,33,1984,6.9,11,8,4,5,2,3,12,25.0,9,12,1,11,8,19,4,0,Matches
281,Lorenzo Insigne,it ITA,FW,it Napoli,26,1991,4.3,1,1,0,1,0,0,7,0.0,7,3,0,3,7,8,0,0,Matches
282,Alexander Isak,se SWE,FW,de Dortmund,17,1999,0.1,0,0,0,0,0,0,0,,0,0,0,0,0,0,0,0,Matches
283,Isco,es ESP,MF,es Real Madrid,25,1992,8.2,14,11,5,4,5,4,21,19.0,17,6,1,5,2,16,1,0,Matches
284,Ismaily,br BRA,DF,ua Shakhtar,27,1990,7.7,14,11,8,5,1,4,8,50.0,4,8,2,6,15,29,17,0,Matches
285,Afran Ismayilov,az AZE,MF,az Qarabağ,28,1988,0.8,6,5,4,2,0,3,4,75.0,1,0,0,0,1,7,0,0,Matches
286,Cedric Itten,ch SUI,MF,ch Basel,20,1996,0.1,0,0,0,0,0,0,0,,0,0,0,0,0,0,0,0,Matches
287,Jardel,br BRA,DF,pt Benfica,31,1986,4.0,6,2,2,4,0,0,3,0.0,3,4,3,1,10,16,10,0,Matches
288,Jemerson,br BRA,DF,fr Monaco,24,1992,6.0,6,5,5,1,0,0,6,0.0,6,7,3,4,13,19,31,2,Matches
289,Gabriel Jesus,br BRA,FW,eng Manchester City,20,1997,6.9,9,6,4,4,1,0,8,0.0,8,9,0,9,7,16,3,0,Matches
290,Juan Jesus,br BRA,DF,it Roma,26,1991,5.7,15,8,9,6,0,7,14,50.0,7,13,11,2,4,19,31,0,Matches
291,Raúl Jiménez,mx MEX,FW,pt Benfica,26,1991,3.4,2,1,0,2,0,1,1,100.0,0,10,0,10,5,7,1,0,Matches
292,Jonas,br BRA,"FW,MF",pt Benfica,33,1984,3.2,3,2,0,3,0,1,4,25.0,3,3,0,3,0,3,2,0,Matches
293,Brad Jones,au AUS,GK,nl Feyenoord,35,1982,5.0,0,0,0,0,0,0,1,0.0,1,0,0,0,1,1,4,0,Matches
294,Jorge,br BRA,DF,fr Monaco,21,1996,4.0,14,9,4,10,0,6,9,66.7,3,4,0,4,9,23,11,0,Matches
295,Jorginho,it ITA,MF,it Napoli,25,1991,1.8,7,3,3,3,1,2,8,25.0,6,6,2,4,3,10,0,0,Matches
296,Stevan Jovetić,me MNE,FW,fr Monaco,27,1989,0.7,0,0,0,0,0,0,0,,0,0,0,0,0,0,1,0,Matches
297,Juanfran,es ESP,DF,es Atlético Madrid,32,1985,3.0,10,8,5,4,1,4,5,80.0,1,1,0,1,5,15,4,0,Matches
298,Nicolai Jørgensen,dk DEN,FW,nl Feyenoord,26,1991,2.9,2,2,0,1,1,0,0,,0,1,1,0,0,2,2,0,Matches
299,Marwan Kabha,il ISR,MF,si NK Maribor,26,1991,5.8,20,13,12,8,0,4,19,21.1,15,7,3,4,6,26,8,0,Matches
300,Shinji Kagawa,jp JPN,"MF,FW",de Dortmund,28,1989,4.5,3,2,0,1,2,0,3,0.0,3,3,0,3,3,6,1,0,Matches
301,Dominik Kaiser,de GER,MF,de RB Leipzig,28,1988,0.2,0,0,0,0,0,0,0,,0,0,0,0,0,0,1,0,Matches
302,Kevin Kampl,si SVN,MF,de RB Leipzig,26,1990,4.6,6,4,0,5,1,3,7,42.9,4,5,0,5,9,15,8,0,Matches
303,Harry Kane,eng ENG,FW,eng Tottenham,24,1993,6.6,2,2,0,2,0,1,5,20.0,4,4,2,2,2,4,8,0,Matches
304,N'Golo Kanté,fr FRA,MF,eng Chelsea,26,1991,5.5,22,18,10,10,2,4,13,30.8,9,8,1,7,15,37,3,0,Matches
305,Stefanos Kapino,gr GRE,GK,gr Olympiacos,23,1994,1.0,0,0,0,0,0,0,0,,0,0,0,0,0,0,0,1,Matches
306,Loris Karius,de GER,GK,eng Liverpool,24,1993,13.0,0,0,0,0,0,0,0,,0,0,0,0,0,0,7,3,Matches
307,Naby Keïta,gn GUI,MF,de RB Leipzig,22,1995,4.7,15,10,4,9,2,3,11,27.3,8,8,1,7,12,27,6,0,Matches
308,Sami Khedira,de GER,MF,it Juventus,30,1987,7.0,11,7,6,4,1,6,16,37.5,10,6,2,4,4,15,11,0,Matches
309,Davit Khocholava,ge GEO,DF,ua Shakhtar,24,1993,1.2,0,0,0,0,0,0,0,,0,1,1,0,1,1,6,0,Matches
310,Khetag Khosonov,ru RUS,MF,ru CSKA Moscow,19,1998,0.0,0,0,0,0,0,0,0,,0,0,0,0,0,0,0,0,Matches
311,Joshua Kimmich,de GER,DF,de Bayern Munich,22,1995,10.0,12,10,5,3,4,6,15,40.0,9,6,1,5,11,23,14,0,Matches
312,Presnel Kimpembe,fr FRA,DF,fr Paris S-G,21,1995,2.2,2,1,2,0,0,0,0,,0,1,0,1,1,3,7,0,Matches
313,Simon Kjær,dk DEN,DF,es Sevilla,28,1989,6.0,12,6,7,5,0,6,9,66.7,3,11,8,3,12,24,33,0,Matches
314,Ragnar Klavan,ee EST,DF,eng Liverpool,31,1985,3.3,1,1,0,1,0,0,1,0.0,1,6,6,0,4,5,18,0,Matches
315,Lukas Klostermann,de GER,DF,de RB Leipzig,21,1996,5.1,9,7,6,3,0,3,11,27.3,8,2,1,1,7,16,11,0,Matches
316,Koke,es ESP,MF,es Atlético Madrid,25,1992,3.7,6,4,5,0,1,2,9,22.2,7,6,0,6,2,8,0,0,Matches
317,Aleksandar Kolarov,rs SRB,DF,it Roma,31,1985,12.0,22,14,9,10,3,9,17,52.9,8,10,2,8,18,40,23,1,Matches
318,Dmitri Kombarov,ru RUS,DF,ru Spartak Moscow,30,1987,4.0,9,4,2,5,2,5,9,55.6,4,6,3,3,8,17,7,0,Matches
319,Vincent Kompany,be BEL,DF,eng Manchester City,31,1986,2.0,2,1,2,0,0,2,5,40.0,3,2,2,0,3,5,4,0,Matches
320,Terence Kongolo,nl NED,DF,fr Monaco,23,1994,1.0,4,3,3,1,0,3,4,75.0,1,4,3,1,1,5,7,0,Matches
321,Eboue Kouassi,ci CIV,MF,sct Celtic,19,1997,0.2,0,0,0,0,0,0,0,,0,1,0,1,0,0,0,0,Matches
322,Kalidou Koulibaly,sn SEN,DF,it Napoli,26,1991,5.0,10,7,8,2,0,3,6,50.0,3,9,7,2,9,19,19,0,Matches
323,Leonardo Koutris,gr GRE,DF,gr Olympiacos,22,1995,5.0,12,10,7,3,2,8,13,61.5,5,5,4,1,8,20,23,1,Matches
324,Mateo Kovačić,hr CRO,MF,es Real Madrid,23,1994,2.9,7,4,3,4,0,3,7,42.9,4,2,0,2,5,12,3,0,Matches
325,Viktor Kovalenko,ua UKR,"MF,FW",ua Shakhtar,21,1996,0.5,0,0,0,0,0,0,1,0.0,1,1,0,1,0,0,0,0,Matches
326,Martin Kramarič,si SVN,FW,si NK Maribor,19,1997,1.1,2,1,2,0,0,1,4,25.0,3,4,0,4,4,6,0,1,Matches
327,Michiel Kramer,nl NED,FW,nl Feyenoord,28,1988,0.9,2,2,0,2,0,0,0,,0,0,0,0,2,4,1,0,Matches
328,Michael Krohn-Dehli,dk DEN,MF,es Sevilla,34,1983,1.6,0,0,0,0,0,0,1,0.0,1,0,0,0,2,2,0,0,Matches
329,Toni Kroos,de GER,MF,es Real Madrid,27,1990,10.6,19,12,7,9,3,5,18,27.8,13,10,0,10,7,26,0,0,Matches
330,Serhiy Kryvtsov,ua UKR,DF,ua Shakhtar,26,1991,0.5,0,0,0,0,0,0,0,,0,1,1,0,2,2,1,0,Matches
331,Konstantin Kuchayev,ru RUS,"MF,FW",ru CSKA Moscow,19,1998,2.5,8,5,2,6,0,3,13,23.1,10,4,2,2,4,12,2,0,Matches
332,Sven Kums,be BEL,MF,be Anderlecht,29,1988,3.8,6,4,2,4,0,2,13,15.4,11,4,1,3,6,12,3,0,Matches
333,Layvin Kurzawa,fr FRA,DF,fr Paris S-G,24,1992,6.0,9,4,5,1,3,2,6,33.3,4,8,1,7,5,14,14,0,Matches
334,Ilya Kutepov,ru RUS,DF,ru Spartak Moscow,24,1993,3.0,11,9,5,6,0,7,8,87.5,1,4,2,2,13,24,14,0,Matches
335,Léo Lacroix,ch SUI,DF,ch Basel,25,1992,2.0,3,2,2,1,0,0,0,,0,5,3,2,3,6,18,0,Matches
336,Roberto Lago,es ESP,DF,cy APOEL FC,31,1985,5.0,11,9,9,2,0,8,14,57.1,6,12,2,10,10,21,16,0,Matches
337,Konrad Laimer,at AUT,MF,de RB Leipzig,20,1997,0.1,0,0,0,0,0,0,0,,0,0,0,0,0,0,0,0,Matches
338,Adam Lallana,eng ENG,FW,eng Liverpool,29,1988,1.7,2,1,1,1,0,1,8,12.5,7,7,0,7,1,3,0,0,Matches
339,Érik Lamela,ar ARG,"FW,MF",eng Tottenham,25,1992,1.2,2,1,0,0,2,0,3,0.0,3,1,0,1,2,4,1,0,Matches
340,Michael Lang,ch SUI,"MF,DF",ch Basel,26,1991,8.0,12,8,6,3,3,7,11,63.6,4,5,2,3,14,26,15,0,Matches
341,Aymeric Laporte,es ESP,DF,eng Manchester City,23,1994,3.0,13,9,9,3,1,5,12,41.7,7,1,0,1,2,15,16,0,Matches
342,Sam Larsson,se SWE,FW,nl Feyenoord,24,1993,1.7,4,2,2,2,0,2,8,25.0,6,4,0,4,5,9,0,0,Matches
343,Miguel Layún,mx MEX,"DF,MF",pt Porto,29,1988,1.2,4,2,1,3,0,1,1,100.0,0,1,0,1,2,6,6,0,Matches
344,Thomas Lemar,fr FRA,"MF,FW",fr Monaco,21,1995,2.0,2,1,1,0,1,0,2,0.0,2,3,0,3,2,4,0,0,Matches
345,Clément Lenglet,fr FRA,DF,es Sevilla,22,1995,9.0,16,12,14,2,0,5,7,71.4,2,12,7,5,17,33,32,0,Matches
346,Jeremain Lens,nl NED,FW,tr Beşiktaş,29,1987,1.7,1,1,0,1,0,0,3,0.0,3,0,0,0,0,1,1,0,Matches
347,Robert Lewandowski,pl POL,FW,de Bayern Munich,28,1988,10.6,7,6,0,2,5,0,12,0.0,12,7,1,6,2,9,3,0,Matches
348,Stephan Lichtsteiner,ch SUI,DF,it Juventus,33,1984,1.1,0,0,0,0,0,0,1,0.0,1,0,0,0,1,1,9,0,Matches
349,Victor Lindelöf,se SWE,DF,eng Manchester Utd,23,1994,5.0,5,2,4,1,0,2,3,66.7,1,10,5,5,7,12,16,0,Matches
350,Jesse Lingard,eng ENG,"MF,FW",eng Manchester Utd,24,1992,2.7,9,4,4,4,1,0,2,0.0,2,1,0,1,0,9,0,0,Matches
351,Fernando Llorente,es ESP,FW,eng Tottenham,32,1985,2.5,1,0,0,0,1,1,3,33.3,2,1,0,1,0,1,5,0,Matches
352,Marcos Llorente,es ESP,MF,es Real Madrid,22,1995,0.2,0,0,0,0,0,0,1,0.0,1,0,0,0,1,1,0,0,Matches
353,Hugo Lloris,fr FRA,GK,eng Tottenham,30,1986,7.0,0,0,0,0,0,0,0,,0,0,0,0,0,0,2,0,Matches
354,Giovani Lo Celso,ar ARG,MF,fr Paris S-G,21,1996,1.7,5,2,3,0,2,3,9,33.3,6,1,0,1,1,6,2,0,Matches
355,Rony Lopes,pt POR,"MF,FW",fr Monaco,21,1995,3.3,5,4,0,5,0,1,5,20.0,4,7,0,7,3,8,1,0,Matches
356,Lisandro López,ar ARG,DF,pt Benfica,27,1989,2.0,6,5,4,2,0,6,6,100.0,0,2,1,1,4,10,8,0,Matches
357,Vágner Love,br BRA,FW,tr Beşiktaş,33,1984,1.5,1,1,0,1,0,1,1,100.0,0,2,0,2,0,1,2,0,Matches
358,Dejan Lovren,hr CRO,DF,eng Liverpool,28,1989,11.7,16,12,13,3,0,9,10,90.0,1,11,6,5,17,33,68,2,Matches
359,Filipe Luís,br BRA,DF,es Atlético Madrid,31,1985,6.0,22,14,13,8,1,8,13,61.5,5,8,1,7,13,35,4,1,Matches
360,Zé Luís,cv CPV,FW,ru Spartak Moscow,26,1991,1.8,0,0,0,0,0,0,1,0.0,1,0,0,0,0,0,2,0,Matches
361,Luisão,br BRA,DF,pt Benfica,36,1981,4.0,6,3,5,1,0,2,5,40.0,3,1,1,0,8,14,17,0,Matches
362,David Luiz,br BRA,"DF,MF",eng Chelsea,30,1987,3.6,7,5,2,4,1,1,7,14.3,6,2,0,2,7,14,5,1,Matches
363,Romelu Lukaku,be BEL,FW,eng Manchester Utd,24,1993,7.8,6,2,1,2,3,1,3,33.3,2,0,0,0,0,6,4,0,Matches
364,Mikael Lustig,se SWE,DF,sct Celtic,30,1986,5.1,14,9,9,4,1,8,13,61.5,5,8,3,5,14,28,28,0,Matches
365,Mahir Madatov,az AZE,"MF,FW",az Qarabağ,20,1997,3.6,13,10,6,6,1,3,7,42.9,4,1,0,1,2,15,4,0,Matches
366,Christian Maggio,it ITA,DF,it Napoli,35,1982,2.6,8,5,3,5,0,2,7,28.6,5,0,0,0,2,10,4,0,Matches
367,Abdul Majeed Waris,gh GHA,"MF,FW",pt Porto,25,1991,1.1,1,1,0,1,0,1,3,33.3,2,0,0,0,2,3,0,0,Matches
368,Andreas Makris,cy CYP,FW,cy APOEL FC,21,1995,0.3,0,0,0,0,0,0,0,,0,0,0,0,2,2,0,0,Matches
369,Nikola Maksimović,rs SRB,DF,it Napoli,25,1991,1.0,0,0,0,0,0,0,1,0.0,1,0,0,0,2,2,4,0,Matches
370,Tyrell Malacia,nl NED,DF,nl Feyenoord,17,1999,1.0,2,1,2,0,0,0,0,,0,1,1,0,1,3,3,0,Matches
371,Mario Mandžukić,hr CRO,FW,it Juventus,31,1986,5.1,8,5,3,4,1,2,5,40.0,3,4,0,4,4,12,8,0,Matches
372,Sadio Mané,sn SEN,"FW,MF",eng Liverpool,25,1992,10.4,22,10,11,6,5,8,21,38.1,13,13,0,13,7,29,7,1,Matches
373,Eliaquim Mangala,fr FRA,DF,eng Manchester City,26,1991,2.0,2,0,1,1,0,1,1,100.0,0,3,3,0,5,7,4,1,Matches
374,Kostas Manolas,gr GRE,DF,it Roma,26,1991,10.2,14,8,9,5,0,7,14,50.0,7,16,10,6,10,24,48,0,Matches
375,Iván Marcano,es ESP,DF,pt Porto,30,1987,7.0,9,6,5,4,0,0,3,0.0,3,5,4,1,9,18,42,1,Matches
376,Marcelo,br BRA,DF,es Real Madrid,29,1988,10.6,17,9,6,9,2,9,26,34.6,17,13,2,11,15,32,11,0,Matches
377,Claudio Marchisio,it ITA,FW,it Juventus,31,1986,0.2,1,1,1,0,0,1,2,50.0,1,1,0,1,0,1,1,0,Matches
378,Moussa Marega,ml MLI,FW,pt Porto,26,1991,4.9,5,3,2,2,1,2,3,66.7,1,1,0,1,5,10,3,0,Matches
379,José María Giménez,uy URU,DF,es Atlético Madrid,22,1995,3.0,9,8,7,2,0,6,13,46.2,7,5,1,4,6,15,18,0,Matches
380,Marko Marin,de GER,"FW,MF",gr Olympiacos,28,1989,1.5,1,1,1,0,0,0,1,0.0,1,1,0,1,1,2,0,0,Matches
381,Marlos,ua UKR,FW,ua Shakhtar,29,1988,7.4,9,6,3,4,2,2,15,13.3,13,7,0,7,2,11,1,0,Matches
382,Marquinhos,br BRA,DF,fr Paris S-G,23,1994,8.0,9,6,4,4,1,1,4,25.0,3,9,4,5,10,19,42,0,Matches
383,Anthony Martial,fr FRA,"FW,MF",eng Manchester Utd,21,1995,3.8,1,1,1,0,0,0,1,0.0,1,1,0,1,1,2,0,0,Matches
384,Javi Martínez,es ESP,"MF,DF",de Bayern Munich,28,1988,8.2,19,9,9,8,2,6,18,33.3,12,9,3,6,19,38,19,0,Matches
385,Gelson Martins,pt POR,FW,pt Sporting CP,22,1995,5.1,8,5,2,5,1,1,5,20.0,4,3,0,3,4,12,5,0,Matches
386,Javier Mascherano,ar ARG,DF,es Barcelona,33,1984,1.5,2,2,0,2,0,1,3,33.3,2,1,1,0,1,3,1,0,Matches
387,Juan Mata,es ESP,"FW,MF",eng Manchester Utd,29,1988,4.6,7,5,3,4,0,1,8,12.5,7,4,0,4,6,13,0,1,Matches
388,Jérémy Mathieu,fr FRA,DF,pt Sporting CP,33,1983,4.9,6,4,4,1,1,3,4,75.0,1,5,3,2,6,12,21,0,Matches
389,Nemanja Matić,rs SRB,MF,eng Manchester Utd,28,1988,6.3,17,11,7,10,0,8,13,61.5,5,5,1,4,14,31,7,0,Matches
390,Joël Matip,cm CMR,DF,eng Liverpool,25,1991,5.2,4,3,3,1,0,1,6,16.7,5,2,2,0,8,12,11,0,Matches
391,Blaise Matuidi,fr FRA,MF,it Juventus,30,1987,5.5,7,5,3,4,0,2,10,20.0,8,4,1,3,9,16,4,0,Matches
392,Borja Mayoral,es ESP,FW,es Real Madrid,20,1997,1.6,1,1,0,1,0,1,2,50.0,1,0,0,0,0,1,2,0,Matches
393,Kylian Mbappé,fr FRA,FW,fr Paris S-G,18,1998,7.3,2,2,1,1,0,0,1,0.0,1,5,0,5,4,6,1,0,Matches
394,Kara Mbodji,sn SEN,DF,be Anderlecht,27,1989,4.3,5,2,5,0,0,2,6,33.3,4,8,6,2,5,10,21,0,Matches
395,Callum McGregor,sct SCO,MF,sct Celtic,24,1993,3.3,6,3,0,4,2,1,3,33.3,2,6,0,6,6,12,2,0,Matches
396,Scott McTominay,sct SCO,MF,eng Manchester Utd,20,1996,2.3,3,1,0,3,0,2,6,33.3,4,4,0,4,3,6,4,0,Matches
397,Gary Medel,cl CHI,"DF,MF",tr Beşiktaş,29,1987,4.8,6,3,5,1,0,2,8,25.0,6,4,3,1,6,12,21,0,Matches
398,Maksim Medvedev,az AZE,DF,az Qarabağ,27,1989,5.8,17,14,14,3,0,9,18,50.0,9,8,4,4,7,24,16,0,Matches
399,Soualiho Meïté,fr FRA,MF,fr Monaco,23,1994,0.7,0,0,0,0,0,0,1,0.0,1,1,0,1,0,0,0,0,Matches
400,Lorenzo Melgarejo,py PAR,"FW,MF",ru Spartak Moscow,26,1990,2.3,3,1,2,1,0,1,4,25.0,3,2,1,1,1,4,9,0,Matches
401,Benjamin Mendy,fr FRA,DF,eng Manchester City,23,1994,1.0,0,0,0,0,0,0,2,0.0,2,0,0,0,0,0,0,0,Matches
402,Gabriel Mercado,ar ARG,DF,es Sevilla,30,1987,7.7,25,12,16,6,3,14,29,48.3,15,9,0,9,9,34,21,0,Matches
403,Giorgos Merkis,cy CYP,DF,cy APOEL FC,33,1984,2.0,4,2,4,0,0,2,2,100.0,0,3,3,0,3,7,19,0,Matches
404,Dries Mertens,be BEL,FW,it Napoli,30,1987,5.3,4,3,0,3,1,1,9,11.1,8,1,0,1,3,7,2,0,Matches
405,Jasmin Mešanović,ba BIH,"FW,MF",si NK Maribor,25,1992,1.1,0,0,0,0,0,0,0,,0,0,0,0,0,0,0,0,Matches
406,Lionel Messi,ar ARG,FW,es Barcelona,30,1987,8.7,9,7,2,5,2,0,7,0.0,7,4,0,4,3,12,0,0,Matches
407,Thomas Meunier,be BEL,DF,fr Paris S-G,25,1991,0.3,0,0,0,0,0,0,0,,0,1,0,1,0,0,0,0,Matches
408,Míchel,es ESP,MF,az Qarabağ,31,1985,5.9,13,11,4,8,1,3,8,37.5,5,8,1,7,9,22,12,0,Matches
409,Georgi Milanov,bg BUL,MF,ru CSKA Moscow,25,1992,1.0,2,1,1,1,0,0,1,0.0,1,3,0,3,2,4,1,0,Matches
410,Martin Milec,si SVN,DF,si NK Maribor,25,1991,6.0,12,9,10,2,0,7,16,43.8,9,8,0,8,13,25,21,1,Matches
411,Arkadiusz Milik,pl POL,FW,it Napoli,23,1994,1.0,0,0,0,0,0,0,0,,0,0,0,0,0,0,0,0,Matches
412,James Milner,eng ENG,MF,eng Liverpool,31,1986,9.7,25,14,12,9,4,7,32,21.9,25,18,6,12,11,36,11,0,Matches
413,Matej Mitrović,hr CRO,DF,tr Beşiktaş,23,1993,1.2,2,2,1,1,0,2,2,100.0,0,2,2,0,4,6,13,0,Matches
414,Henrikh Mkhitaryan,am ARM,MF,eng Manchester Utd,28,1989,3.2,10,7,1,6,3,2,9,22.2,7,6,0,6,3,13,1,0,Matches
415,Luka Modrić,hr CRO,MF,es Real Madrid,31,1985,10.6,15,8,5,8,2,5,18,27.8,13,9,2,7,14,29,4,0,Matches
416,Nuno Morais,pt POR,"MF,DF",cy APOEL FC,33,1984,5.7,11,9,5,6,0,3,18,16.7,15,9,6,3,5,16,13,0,Matches
417,Álvaro Morata,es ESP,FW,eng Chelsea,24,1992,4.3,1,1,0,1,0,0,4,0.0,4,1,0,1,1,2,6,0,Matches
418,Alberto Moreno,es ESP,DF,eng Liverpool,25,1992,6.3,17,11,8,6,3,9,14,64.3,5,6,0,6,9,26,27,0,Matches
419,Victor Moses,ng NGA,DF,eng Chelsea,26,1990,3.7,9,7,6,3,0,7,9,77.8,2,1,0,1,2,11,9,0,Matches
420,Thiago Motta,it ITA,MF,fr Paris S-G,34,1982,3.4,7,6,4,3,0,3,11,27.3,8,8,1,7,2,9,6,1,Matches
421,Lucas Moura,br BRA,FW,eng Tottenham,24,1992,0.0,0,0,0,0,0,0,0,,0,0,0,0,0,0,0,0,Matches
422,João Moutinho,pt POR,MF,fr Monaco,30,1986,5.2,15,6,5,8,2,7,17,41.2,10,6,3,3,7,22,8,0,Matches
423,Thomas Müller,de GER,"MF,FW",de Bayern Munich,27,1989,8.2,10,8,4,5,1,4,8,50.0,4,8,0,8,4,14,5,0,Matches
424,Luis Muriel,co COL,FW,es Sevilla,26,1991,2.8,3,1,0,2,1,0,4,0.0,4,1,0,1,2,5,0,0,Matches
425,Kévin N'Doram,fr FRA,MF,fr Monaco,21,1996,1.0,0,0,0,0,0,0,2,0.0,2,1,0,1,1,1,0,0,Matches
426,Georges-Kévin N'Koudou,cm CMR,"MF,FW",eng Tottenham,22,1995,1.2,0,0,0,0,0,0,1,0.0,1,0,0,0,0,0,0,0,Matches
427,Kirill Nababkin,ru RUS,MF,ru CSKA Moscow,30,1986,1.4,2,2,2,0,0,0,4,0.0,4,1,0,1,1,3,5,0,Matches
428,Ben Nabouhane,km COM,FW,gr Olympiacos,28,1989,0.4,0,0,0,0,0,0,0,,0,0,0,0,0,0,1,0,Matches
429,Nacho,es ESP,DF,es Real Madrid,27,1990,6.6,22,15,14,7,1,8,18,44.4,10,4,2,2,13,35,18,0,Matches
430,Radja Nainggolan,be BEL,MF,it Roma,29,1988,10.7,18,11,3,11,4,6,16,37.5,10,10,0,10,4,22,4,2,Matches
431,Andy Najar,hn HON,DF,be Anderlecht,24,1993,0.3,1,1,1,0,0,1,1,100.0,0,0,0,0,0,1,1,0,Matches
432,Bibras Natkho,il ISR,MF,ru CSKA Moscow,29,1988,2.6,9,5,4,4,1,3,9,33.3,6,2,1,1,6,15,3,0,Matches
433,Jesús Navas,es ESP,"DF,FW",es Sevilla,31,1985,4.7,3,1,2,1,0,0,2,0.0,2,2,0,2,8,11,16,0,Matches
434,Keylor Navas,cr CRC,GK,es Real Madrid,30,1986,11.0,0,0,0,0,0,0,0,,0,0,0,0,2,2,1,2,Matches
435,Dino Ndlovu,za RSA,FW,az Qarabağ,27,1990,4.7,4,2,0,3,1,0,3,0.0,3,1,1,0,2,6,3,0,Matches
436,Álvaro Negredo,es ESP,FW,tr Beşiktaş,31,1985,1.2,0,0,0,0,0,0,2,0.0,2,2,0,2,0,0,3,0,Matches
437,Miquel Nelom,nl NED,DF,nl Feyenoord,26,1990,1.0,2,2,2,0,0,2,3,66.7,1,1,0,1,1,3,4,0,Matches
438,Manuel Neuer,de GER,GK,de Bayern Munich,31,1986,1.0,0,0,0,0,0,0,0,,0,0,0,0,0,0,0,0,Matches
439,Neymar,br BRA,FW,fr Paris S-G,25,1992,7.0,11,6,2,6,3,2,8,25.0,6,7,0,7,1,12,0,0,Matches
440,Bart Nieuwkoop,nl NED,DF,nl Feyenoord,21,1996,2.7,9,7,8,0,1,2,4,50.0,2,6,4,2,16,25,12,0,Matches
441,Saúl Ñíguez,es ESP,MF,es Atlético Madrid,22,1994,6.0,20,14,6,11,3,9,19,47.4,10,14,3,11,14,34,19,0,Matches
442,Dimitris Nikolaou,gr GRE,DF,gr Olympiacos,18,1998,3.0,3,3,3,0,0,0,1,0.0,1,6,3,3,5,8,15,0,Matches
443,Nolito,es ESP,FW,es Sevilla,30,1986,3.5,4,2,2,1,1,2,7,28.6,5,2,0,2,3,7,3,0,Matches
444,Olivier Ntcham,cm CMR,MF,sct Celtic,21,1996,4.3,15,12,5,8,2,3,9,33.3,6,2,1,1,3,18,4,3,Matches
445,Steven Nzonzi,fr FRA,MF,es Sevilla,28,1988,7.5,11,8,7,3,1,2,9,22.2,7,11,4,7,12,23,16,0,Matches
446,Dimitri Oberlin,ch SUI,FW,ch Basel,19,1997,5.9,12,7,4,7,1,3,12,25.0,9,10,0,10,4,16,7,0,Matches
447,Jan Oblak,si SVN,GK,es Atlético Madrid,24,1993,6.0,0,0,0,0,0,0,0,,0,0,0,0,0,0,1,0,Matches
448,Ivan Obradović,rs SRB,DF,be Anderlecht,29,1988,2.0,2,1,1,1,0,1,3,33.3,2,1,1,0,1,3,3,0,Matches
449,Vadis Odjidja-Ofoe,be BEL,"MF,FW",gr Olympiacos,28,1989,4.6,10,8,7,2,1,0,7,0.0,7,6,1,5,4,14,3,0,Matches
450,Mattheus Oliveira,br BRA,FW,pt Sporting CP,23,1994,0.0,0,0,0,0,0,0,0,,0,0,0,0,0,0,0,0,Matches
451,Sérgio Oliveira,pt POR,MF,pt Porto,25,1992,3.9,22,18,9,12,1,7,13,53.8,6,4,1,3,3,25,6,0,Matches
452,Henry Onyekuru,ng NGA,"FW,MF",be Anderlecht,20,1997,4.5,1,1,1,0,0,1,2,50.0,1,5,0,5,1,2,0,0,Matches
453,Willi Orban,hu HUN,DF,de RB Leipzig,24,1992,5.3,10,8,4,5,1,5,11,45.5,6,10,2,8,7,17,30,0,Matches
454,Ivan Ordets,ua UKR,DF,ua Shakhtar,25,1992,7.4,14,8,9,5,0,3,7,42.9,4,5,4,1,14,28,44,0,Matches
455,Nicolás Otamendi,ar ARG,DF,eng Manchester City,29,1988,8.0,17,14,11,5,1,7,13,53.8,6,5,3,2,18,35,39,1,Matches
456,Otávio,pt POR,MF,pt Porto,22,1995,1.0,0,0,0,0,0,0,2,0.0,2,0,0,0,1,1,0,0,Matches
457,Adam Ounas,dz ALG,"FW,MF",it Napoli,20,1996,0.4,2,2,1,1,0,0,1,0.0,1,0,0,0,0,2,0,0,Matches
458,Alex Oxlade-Chamberlain,eng ENG,"FW,MF",eng Liverpool,23,1993,3.6,7,4,4,3,0,2,8,25.0,6,7,2,5,3,10,5,0,Matches
459,Oğuzhan Özyakup,tr TUR,MF,tr Beşiktaş,24,1992,4.9,10,6,2,8,0,5,15,33.3,10,12,3,9,9,19,6,0,Matches
460,Gonçalo Paciência,pt POR,FW,pt Porto,22,1994,0.3,2,1,0,2,0,0,1,0.0,1,0,0,0,0,2,0,0,Matches
461,João Palhinha,pt POR,MF,pt Sporting CP,22,1995,0.4,0,0,0,0,0,0,3,0.0,3,1,1,0,2,2,4,0,Matches
462,Sokratis Papastathopoulos,gr GRE,DF,de Dortmund,29,1988,5.0,13,8,11,2,0,4,8,50.0,4,4,2,2,8,21,25,0,Matches
463,Felipe Pardo,co COL,"MF,FW",gr Olympiacos,26,1990,3.3,1,1,0,0,1,0,2,0.0,2,4,0,4,3,4,3,0,Matches
464,Nicolás Pareja,ar ARG,DF,es Sevilla,33,1984,2.0,6,3,2,4,0,4,4,100.0,0,5,3,2,6,12,8,0,Matches
465,Thomas Partey,gh GHA,"MF,DF",es Atlético Madrid,24,1993,4.8,9,6,6,3,0,4,15,26.7,11,6,3,3,6,15,6,1,Matches
466,Mario Pašalić,hr CRO,MF,ru Spartak Moscow,22,1995,3.9,13,8,7,6,0,5,12,41.7,7,5,1,4,7,20,2,0,Matches
467,Javier Pastore,ar ARG,"MF,FW",fr Paris S-G,28,1989,0.8,1,0,0,0,1,0,2,0.0,2,4,0,4,2,3,0,0,Matches
468,Rui Patrício,pt POR,GK,pt Sporting CP,29,1988,6.0,0,0,0,0,0,0,0,,0,0,0,0,2,2,4,1,Matches
469,Alan Patrick,br BRA,MF,ua Shakhtar,26,1991,0.6,3,2,1,1,1,2,2,100.0,0,0,0,0,1,4,1,0,Matches
470,Paulinho,br BRA,MF,es Barcelona,29,1988,4.5,11,6,5,2,4,1,10,10.0,9,2,1,1,5,16,5,0,Matches
471,Pedro,es ESP,"MF,FW",eng Chelsea,30,1987,4.3,7,4,6,1,0,2,9,22.2,7,0,0,0,9,16,1,0,Matches
472,Mustafa Pektemek,tr TUR,"FW,MF",tr Beşiktaş,28,1988,1.8,3,1,2,1,0,1,3,33.3,2,1,0,1,2,5,1,0,Matches
473,Lorenzo Pellegrini,it ITA,"MF,FW",it Roma,21,1996,3.3,5,3,1,4,0,1,3,33.3,2,4,1,3,4,9,2,0,Matches
474,Pepe,pt POR,DF,tr Beşiktaş,34,1983,6.0,16,11,7,8,1,3,7,42.9,4,16,12,4,13,29,41,2,Matches
475,Danilo Pereira,pt POR,MF,pt Porto,25,1991,5.9,13,11,7,6,0,3,11,27.3,8,7,4,3,10,23,8,0,Matches
476,Maxi Pereira,uy URU,"DF,MF",pt Porto,33,1984,2.2,4,2,3,1,0,1,5,20.0,4,2,0,2,5,9,6,0,Matches
477,Ricardo Pereira,pt POR,"DF,FW",pt Porto,23,1993,6.1,18,13,13,4,1,8,16,50.0,8,11,2,9,12,30,12,0,Matches
478,Bruno Peres,br BRA,DF,it Roma,27,1990,5.1,10,8,7,2,1,5,9,55.6,4,5,2,3,11,21,12,0,Matches
479,Nauzet Pérez,es ESP,GK,cy APOEL FC,32,1985,3.0,1,0,1,0,0,1,1,100.0,0,0,0,0,1,2,5,2,Matches
480,Diego Perotti,ar ARG,FW,it Roma,29,1988,8.1,17,12,8,5,4,7,26,26.9,19,9,0,9,8,25,3,0,Matches
481,Marko Petković,rs SRB,DF,ru Spartak Moscow,24,1992,0.9,2,0,2,0,0,1,1,100.0,0,2,0,2,2,4,2,0,Matches
482,Raoul Petretta,it ITA,MF,ch Basel,20,1997,4.6,9,6,5,3,1,1,3,33.3,2,12,3,9,8,17,11,0,Matches
483,Radosav Petrović,rs SRB,"MF,DF",pt Sporting CP,28,1989,0.0,0,0,0,0,0,0,0,,0,0,0,0,0,0,0,0,Matches
484,Ivan Petryak,ua UKR,FW,ua Shakhtar,23,1994,0.0,0,0,0,0,0,0,0,,0,0,0,0,0,0,0,0,Matches
485,Maximilian Philipp,de GER,"FW,MF",de Dortmund,23,1994,1.9,4,2,0,1,3,0,0,,0,2,0,2,0,4,1,0,Matches
486,Cristiano Piccini,it ITA,DF,pt Sporting CP,24,1992,4.9,8,5,3,5,0,2,3,66.7,1,16,3,13,8,16,12,0,Matches
487,Aleks Pihler,si SVN,MF,si NK Maribor,23,1994,4.4,7,5,4,3,0,2,5,40.0,3,5,2,3,3,10,10,0,Matches
488,Gerard Piqué,es ESP,DF,es Barcelona,30,1987,8.2,12,9,9,3,0,5,7,71.4,2,9,7,2,6,18,38,0,Matches
489,Łukasz Piszczek,pl POL,DF,de Dortmund,32,1985,2.0,2,1,0,2,0,0,1,0.0,1,1,0,1,5,7,7,0,Matches
490,Guido Pizarro,ar ARG,MF,es Sevilla,27,1990,5.6,14,9,1,8,5,6,18,33.3,12,7,0,7,2,16,6,1,Matches
491,Pizzi,pt POR,MF,pt Benfica,27,1989,5.3,9,5,3,6,0,5,18,27.8,13,6,2,4,2,11,2,1,Matches
492,Miralem Pjanić,ba BIH,MF,it Juventus,27,1990,7.0,10,9,5,3,2,0,15,0.0,15,15,6,9,8,18,9,0,Matches
493,Paul Pogba,fr FRA,MF,eng Manchester Utd,24,1993,3.1,8,5,1,6,1,1,3,33.3,2,1,1,0,3,11,2,0,Matches
494,Ivelin Popov,bg BUL,MF,ru Spartak Moscow,29,1987,2.7,5,2,1,4,0,2,4,50.0,2,4,0,4,1,6,1,0,Matches
495,Mickaël Poté,bj BEN,FW,cy APOEL FC,32,1984,3.5,3,2,2,1,0,1,3,33.3,2,5,0,5,2,5,4,0,Matches
496,Yussuf Poulsen,dk DEN,FW,de RB Leipzig,23,1994,2.2,2,2,0,2,0,0,1,0.0,1,0,0,0,0,2,2,0,Matches
497,Quincy Promes,nl NED,"FW,MF",ru Spartak Moscow,25,1992,4.8,2,0,1,0,1,2,5,40.0,3,4,0,4,2,4,0,0,Matches
498,Silvio Proto,be BEL,GK,gr Olympiacos,34,1983,5.0,0,0,0,0,0,0,0,,0,0,0,0,2,2,4,0,Matches
499,Christian Pulisic,us USA,"FW,MF",de Dortmund,18,1998,4.2,6,5,1,2,3,1,5,20.0,4,3,0,3,2,8,0,0,Matches
500,Andriy Pyatov,ua UKR,GK,ua Shakhtar,33,1984,8.0,1,0,1,0,0,1,2,50.0,1,0,0,0,1,2,4,1,Matches
501,Ricardo Quaresma,pt POR,FW,tr Beşiktaş,33,1983,6.8,8,4,2,6,0,1,5,20.0,4,4,0,4,3,11,1,0,Matches
502,Dani Quintana,es ESP,"FW,MF",az Qarabağ,30,1987,0.4,0,0,0,0,0,0,3,0.0,3,0,0,0,0,0,0,0,Matches
503,Adrien Rabiot,fr FRA,MF,fr Paris S-G,22,1995,7.5,12,10,6,6,0,2,10,20.0,8,10,1,9,12,24,18,1,Matches
504,Rafinha,br BRA,DF,de Bayern Munich,31,1985,5.6,17,11,9,5,3,8,14,57.1,6,2,0,2,13,30,13,1,Matches
505,Andrea Raggi,it ITA,DF,fr Monaco,33,1984,2.0,3,0,1,2,0,2,2,100.0,0,2,0,2,3,6,3,0,Matches
506,Aleksander Rajčević,si SVN,DF,si NK Maribor,30,1986,4.0,1,0,1,0,0,0,2,0.0,2,5,5,0,7,8,21,0,Matches
507,Ivan Rakitić,hr CRO,MF,es Barcelona,29,1988,8.4,13,8,4,6,3,4,16,25.0,12,5,1,4,16,29,2,1,Matches
508,Yaroslav Rakitskiy,ua UKR,DF,ua Shakhtar,27,1989,6.8,9,7,7,2,0,5,7,71.4,2,6,4,2,13,22,25,0,Matches
509,Anthony Ralston,sct SCO,DF,sct Celtic,18,1998,1.0,3,2,0,3,0,2,4,50.0,2,1,1,0,1,4,6,0,Matches
510,Aghabala Ramazanov,az AZE,MF,az Qarabağ,24,1993,0.1,0,0,0,0,0,0,1,0.0,1,0,0,0,0,0,0,0,Matches
511,Sandro Ramírez,es ESP,FW,es Sevilla,22,1995,0.4,1,1,0,1,0,1,2,50.0,1,2,0,2,0,1,0,0,Matches
512,Sergio Ramos,es ESP,DF,es Real Madrid,31,1986,11.0,19,14,15,4,0,6,19,31.6,13,20,13,7,18,37,49,1,Matches
513,Marcus Rashford,eng ENG,"FW,MF",eng Manchester Utd,19,1997,3.8,4,2,2,2,0,1,5,20.0,4,3,0,3,1,5,0,0,Matches
514,Artyom Rebrov,ru RUS,GK,ru Spartak Moscow,33,1984,1.8,0,0,0,0,0,0,0,,0,0,0,0,0,0,0,0,Matches
515,Pepe Reina,es ESP,GK,it Napoli,34,1982,6.0,0,0,0,0,0,0,0,,0,0,0,0,0,0,2,1,Matches
516,Diego Reyes,mx MEX,DF,pt Porto,24,1992,2.6,5,4,3,2,0,0,0,,0,5,3,2,4,9,13,0,Matches
517,Franck Ribéry,fr FRA,"MF,FW",de Bayern Munich,34,1983,6.4,4,2,2,1,1,1,10,10.0,9,5,0,5,4,8,4,0,Matches
518,Sergio Rico,es ESP,GK,es Sevilla,23,1993,8.0,0,0,0,0,0,0,0,,0,0,0,0,0,0,2,0,Matches
519,Stefan Ristovski,mk MKD,DF,pt Sporting CP,25,1992,1.6,5,5,3,2,0,2,2,100.0,0,2,1,1,6,11,5,0,Matches
520,Blas Riveros,py PAR,"DF,MF",ch Basel,19,1998,3.2,7,5,7,0,0,6,12,50.0,6,1,1,0,5,12,11,0,Matches
521,Arjen Robben,nl NED,"FW,MF",de Bayern Munich,33,1984,5.5,5,4,2,2,1,1,7,14.3,6,4,0,4,1,6,1,0,Matches
522,Sergi Roberto,es ESP,"MF,DF",es Barcelona,25,1992,6.6,15,12,5,5,5,5,13,38.5,8,8,1,7,4,19,4,0,Matches
523,Patrick Roberts,eng ENG,FW,sct Celtic,20,1997,2.6,9,7,6,2,1,4,12,33.3,8,2,0,2,1,10,2,0,Matches
524,Andrew Robertson,sct SCO,DF,eng Liverpool,23,1994,6.0,11,4,9,2,0,6,16,37.5,10,8,4,4,5,16,28,0,Matches
525,Pedro Rocha Neves,br BRA,MF,ru Spartak Moscow,22,1994,0.0,0,0,0,0,0,0,0,,0,0,0,0,0,0,0,0,Matches
526,James Rodríguez,co COL,"MF,FW",de Bayern Munich,26,1991,8.7,18,12,4,7,7,8,24,33.3,16,11,0,11,9,27,0,0,Matches
527,Marko Rog,hr CRO,"MF,FW",it Napoli,22,1995,0.8,2,1,1,1,0,0,2,0.0,2,1,0,1,2,4,0,0,Matches
528,Tom Rogić,au AUS,"MF,FW",sct Celtic,24,1992,3.3,6,6,1,5,0,4,6,66.7,2,4,0,4,3,9,0,0,Matches
529,Marcos Rojo,ar ARG,DF,eng Manchester Utd,27,1990,1.0,1,0,1,0,0,1,2,50.0,1,1,1,0,3,4,3,0,Matches
530,Alaixys Romao,tg TOG,"MF,DF",gr Olympiacos,33,1984,6.0,15,12,9,6,0,6,17,35.3,11,8,2,6,7,22,8,0,Matches
531,Sergio Romero,ar ARG,GK,eng Manchester Utd,30,1987,2.0,0,0,0,0,0,0,0,,0,0,0,0,0,0,0,0,Matches
532,Cristiano Ronaldo,pt POR,FW,es Real Madrid,32,1985,13.0,5,2,1,4,0,1,4,25.0,3,8,3,5,3,8,10,0,Matches
533,Danny Rose,eng ENG,DF,eng Tottenham,27,1990,1.9,9,7,4,5,0,5,5,100.0,0,4,1,3,3,12,4,0,Matches
534,Antonio Rüdiger,de GER,DF,eng Chelsea,24,1993,4.3,7,7,3,4,0,3,8,37.5,5,1,0,1,6,13,11,1,Matches
535,Sebastian Rudy,de GER,MF,de Bayern Munich,27,1990,3.8,10,6,4,5,1,4,14,28.6,10,2,0,2,6,16,3,0,Matches
536,Jesús Rueda,es ESP,DF,cy APOEL FC,30,1987,6.0,12,8,11,1,0,5,9,55.6,4,10,8,2,10,22,39,2,Matches
537,Daniele Rugani,it ITA,DF,it Juventus,23,1994,1.2,1,1,0,0,1,0,0,,0,2,1,1,0,1,4,0,Matches
538,Mário Rui,pt POR,"DF,FW",it Napoli,26,1991,0.3,1,1,0,0,1,0,1,0.0,1,0,0,0,1,2,1,0,Matches
539,Alan Ruiz,ar ARG,FW,pt Sporting CP,23,1993,0.5,1,0,0,1,0,0,0,,0,0,0,0,0,1,0,0,Matches
540,Jakub Rzeźniczak,pl POL,DF,az Qarabağ,30,1986,4.2,10,6,9,1,0,7,8,87.5,1,6,6,0,15,25,21,0,Matches
541,José Sá,pt POR,GK,pt Porto,24,1993,5.0,0,0,0,0,0,0,1,0.0,1,0,0,0,0,0,4,2,Matches
542,Josué Sá,pt POR,DF,be Anderlecht,25,1992,1.0,2,2,2,0,0,2,3,66.7,1,2,1,1,1,3,4,1,Matches
543,Marcel Sabitzer,at AUT,"MF,FW",de RB Leipzig,23,1994,4.4,8,5,2,5,1,1,7,14.3,6,3,0,3,2,10,4,0,Matches
544,Rashad Sadygov,az AZE,DF,az Qarabağ,35,1982,4.0,2,1,1,1,0,0,0,,0,10,8,2,6,8,16,0,Matches
545,Nuri Şahin,tr TUR,MF,de Dortmund,28,1988,2.4,4,2,2,1,1,2,7,28.6,5,3,3,0,9,13,1,0,Matches
546,Mohamed Salah,eg EGY,FW,eng Liverpool,25,1992,10.3,6,4,1,3,2,0,7,0.0,7,4,0,4,5,11,3,0,Matches
547,Roland Sallai,hu HUN,"MF,FW",cy APOEL FC,20,1997,3.2,1,1,1,0,0,0,3,0.0,3,3,1,2,2,3,5,0,Matches
548,Eduardo Salvio,ar ARG,"MF,FW",pt Benfica,27,1990,4.4,9,7,4,3,2,3,4,75.0,1,4,0,4,8,17,3,0,Matches
549,Andreas Samaris,gr GRE,MF,pt Benfica,28,1989,2.0,4,3,0,4,0,1,3,33.3,2,5,0,5,3,7,0,1,Matches
550,Aleksandr Samedov,ru RUS,"MF,FW",ru Spartak Moscow,33,1984,2.1,0,0,0,0,0,0,4,0.0,4,2,0,2,2,2,6,0,Matches
551,Aaron Samuel Olanare,ng NGA,FW,ru CSKA Moscow,23,1994,0.7,0,0,0,0,0,0,0,,0,2,0,2,0,0,0,0,Matches
552,Alexis Sánchez,cl CHI,"FW,MF",eng Manchester Utd,28,1988,1.8,4,3,0,4,0,0,6,0.0,6,2,0,2,2,6,0,0,Matches
553,Davinson Sánchez,co COL,DF,eng Tottenham,21,1996,8.0,7,5,3,4,0,3,11,27.3,8,11,6,5,16,23,31,0,Matches
554,Alex Sandro,br BRA,DF,it Juventus,26,1991,10.0,30,18,18,6,6,6,15,40.0,9,9,3,6,8,38,14,1,Matches
555,Leroy Sané,de GER,"FW,MF",eng Manchester City,21,1996,7.3,7,6,0,4,3,1,4,25.0,3,12,0,12,3,10,1,1,Matches
556,Pablo Sarabia,es ESP,FW,es Sevilla,25,1992,8.2,11,7,3,5,3,2,21,9.5,19,10,1,9,9,20,7,0,Matches
557,Stefan Savić,me MNE,DF,es Atlético Madrid,26,1991,3.0,3,3,1,1,1,0,3,0.0,3,4,3,1,6,9,10,0,Matches
558,Patrik Schick,cz CZE,"FW,MF",it Roma,21,1996,2.3,3,3,0,3,0,1,4,25.0,3,4,0,4,0,3,0,0,Matches
559,Marcel Schmelzer,de GER,DF,de Dortmund,29,1988,3.0,5,4,3,1,1,4,5,80.0,1,3,2,1,11,16,10,0,Matches
560,André Schürrle,de GER,DF,de Dortmund,26,1990,0.0,0,0,0,0,0,0,0,,0,0,0,0,0,0,0,0,Matches
561,Sebá,br BRA,"FW,MF",gr Olympiacos,25,1992,2.0,5,3,2,3,0,0,6,0.0,6,4,0,4,1,6,4,0,Matches
562,Haris Seferović,ch SUI,FW,pt Benfica,25,1992,2.4,0,0,0,0,0,0,1,0.0,1,1,0,1,1,1,1,0,Matches
563,Ibrahim Šehić,ba BIH,GK,az Qarabağ,28,1988,6.0,0,0,0,0,0,0,0,,0,0,0,0,1,1,3,1,Matches
564,Aleksandr Selikhov,ru RUS,GK,ru Spartak Moscow,23,1994,4.2,1,1,1,0,0,1,1,100.0,0,0,0,0,0,1,1,0,Matches
565,Matz Sels,be BEL,GK,be Anderlecht,25,1992,3.0,1,0,1,0,0,1,2,50.0,1,0,0,0,0,1,1,0,Matches
566,Nélson Semedo,pt POR,DF,es Barcelona,23,1993,6.9,15,13,11,4,0,8,17,47.1,9,8,1,7,8,23,15,0,Matches
567,Stephan El Shaarawy,it ITA,FW,it Roma,24,1992,4.0,2,1,2,0,0,0,2,0.0,2,1,0,1,4,6,1,0,Matches
568,Luke Shaw,eng ENG,DF,eng Manchester Utd,22,1995,1.0,0,0,0,0,0,0,1,0.0,1,2,0,2,2,2,7,0,Matches
569,Georgi Shchennikov,ru RUS,"FW,DF",ru CSKA Moscow,26,1991,4.6,6,4,5,1,0,4,9,44.4,5,3,0,3,12,18,12,0,Matches
570,Ramil Sheydayev,az AZE,FW,az Qarabağ,21,1996,0.9,1,1,0,1,0,1,3,33.3,2,0,0,0,0,1,0,0,Matches
571,Djibril Sidibé,fr FRA,"DF,FW",fr Monaco,25,1992,2.8,6,4,3,3,0,1,4,25.0,3,3,1,2,5,11,6,0,Matches
572,Bernardo Silva,pt POR,"FW,MF",eng Manchester City,22,1994,6.3,10,3,3,3,4,3,17,17.6,14,6,1,5,5,15,2,0,Matches
573,David Silva,es ESP,MF,eng Manchester City,31,1986,4.7,3,1,2,1,0,1,1,100.0,0,2,0,2,6,9,2,0,Matches
574,Jonathan Silva,ar ARG,DF,pt Sporting CP,23,1994,2.3,9,7,7,2,0,7,8,87.5,1,4,0,4,2,11,5,0,Matches
575,Rafa Silva,pt POR,DF,pt Benfica,24,1993,0.0,0,0,0,0,0,0,0,,0,0,0,0,0,0,0,0,Matches
576,Thiago Silva,br BRA,DF,fr Paris S-G,32,1984,5.8,5,3,4,1,0,3,4,75.0,1,8,4,4,4,9,30,0,Matches
577,Jozo Šimunović,hr CRO,DF,sct Celtic,22,1994,4.0,3,1,2,1,0,2,3,66.7,1,0,0,0,14,17,22,0,Matches
578,Scott Sinclair,eng ENG,"FW,MF",sct Celtic,28,1989,4.2,2,1,1,1,0,0,5,0.0,5,2,0,2,1,3,4,0,Matches
579,Moussa Sissoko,fr FRA,MF,eng Tottenham,27,1989,3.8,9,6,5,3,1,5,9,55.6,4,1,0,1,4,13,8,0,Matches
580,Chris Smalling,eng ENG,DF,eng Manchester Utd,27,1989,8.0,10,5,6,3,1,4,7,57.1,3,14,10,4,3,13,27,0,Matches
581,Tiquinho Soares,br BRA,FW,pt Porto,26,1991,2.0,0,0,0,0,0,0,0,,0,0,0,0,1,1,0,0,Matches
582,Dominic Solanke,eng ENG,"FW,MF",eng Liverpool,19,1997,0.4,1,0,1,0,0,0,1,0.0,1,1,0,1,0,1,0,0,Matches
583,David Soria,es ESP,GK,es Sevilla,24,1993,2.0,0,0,0,0,0,0,0,,0,0,0,0,0,0,2,0,Matches
584,Uroš Spajić,rs SRB,DF,be Anderlecht,24,1993,4.0,2,2,2,0,0,1,2,50.0,1,6,6,0,10,12,25,0,Matches
585,Darijo Srna,hr CRO,DF,ua Shakhtar,35,1982,1.0,0,0,0,0,0,0,0,,0,1,1,0,2,2,4,0,Matches
586,Jerry St. Juste,nl NED,DF,nl Feyenoord,20,1996,4.2,8,4,7,1,0,3,3,100.0,0,4,0,4,8,16,15,0,Matches
587,Nicolae Stanciu,ro ROU,"MF,FW",be Anderlecht,24,1993,1.1,2,1,2,0,0,2,3,66.7,1,1,0,1,0,2,0,0,Matches
588,Renato Steffen,ch SUI,FW,ch Basel,25,1991,6.0,7,5,1,5,1,3,8,37.5,5,2,0,2,6,13,4,0,Matches
589,Taras Stepanenko,ua UKR,MF,ua Shakhtar,27,1989,7.6,18,11,10,8,0,5,15,33.3,10,6,4,2,14,32,9,0,Matches
590,Kazaiah Sterling,eng ENG,MF,eng Tottenham,18,1998,0.0,0,0,0,0,0,0,0,,0,0,0,0,0,0,0,0,Matches
591,Raheem Sterling,eng ENG,"FW,MF",eng Manchester City,22,1994,5.5,4,2,1,2,1,0,3,0.0,3,8,0,8,5,9,0,0,Matches
592,Valentin Stocker,ch SUI,MF,ch Basel,28,1989,1.0,0,0,0,0,0,0,1,0.0,1,1,0,1,3,3,0,0,Matches
593,John Stones,eng ENG,DF,eng Manchester City,23,1994,5.0,3,2,2,1,0,2,4,50.0,2,8,6,2,6,9,25,0,Matches
594,Kevin Strootman,nl NED,MF,it Roma,27,1990,9.3,21,15,9,9,3,5,22,22.7,17,11,3,8,12,33,2,0,Matches
595,Stefano Sturaro,it ITA,DF,it Juventus,24,1993,2.6,7,4,3,3,1,4,7,57.1,3,2,1,1,0,7,4,0,Matches
596,Daniel Sturridge,eng ENG,FW,eng Liverpool,27,1989,0.9,0,0,0,0,0,0,0,,0,0,0,0,0,0,1,0,Matches
597,Denis Suárez,es ESP,MF,es Barcelona,23,1994,1.9,1,0,0,0,1,0,6,0.0,6,1,0,1,0,1,0,0,Matches
598,Luis Suárez,uy URU,FW,es Barcelona,30,1987,9.8,4,4,1,1,2,1,10,10.0,9,5,0,5,2,6,5,0,Matches
599,Danijel Subašić,hr CRO,GK,fr Monaco,32,1984,3.0,0,0,0,0,0,0,0,,0,0,0,0,0,0,0,0,Matches
600,Neven Subotić,rs SRB,DF,de Dortmund,28,1988,1.0,0,0,0,0,0,0,0,,0,2,2,0,0,0,9,0,Matches
601,Marek Suchý,cz CZE,DF,ch Basel,29,1988,8.0,10,8,7,2,1,7,15,46.7,8,8,4,4,26,36,42,1,Matches
602,Niklas Süle,de GER,DF,de Bayern Munich,21,1995,7.1,7,6,5,2,0,4,7,57.1,3,11,9,2,11,18,16,0,Matches
603,Marko Šuler,si SVN,DF,si NK Maribor,34,1983,5.0,7,4,7,0,0,3,7,42.9,4,8,5,3,10,17,28,2,Matches
604,Mile Svilar,rs SRB,GK,pt Benfica,17,1999,3.0,0,0,0,0,0,0,0,,0,0,0,0,0,0,4,2,Matches
605,Wojciech Szczęsny,pl POL,GK,it Juventus,27,1990,1.0,0,0,0,0,0,0,0,,0,0,0,0,0,0,0,0,Matches
606,Panagiotis Tachtsidis,gr GRE,MF,gr Olympiacos,26,1991,2.7,7,5,2,5,0,1,6,16.7,5,3,2,1,6,13,4,0,Matches
607,Taison,br BRA,"MF,FW",ua Shakhtar,29,1988,8.0,6,4,1,1,4,0,9,0.0,9,12,1,11,4,10,3,0,Matches
608,Talisca,br BRA,MF,tr Beşiktaş,23,1994,6.0,5,4,3,2,0,2,18,11.1,16,7,0,7,5,10,5,0,Matches
609,Renato Tapia,pe PER,DF,nl Feyenoord,22,1995,3.7,6,4,3,3,0,1,4,25.0,3,5,3,2,6,12,10,1,Matches
610,Serdar Tasci,de GER,DF,ru Spartak Moscow,30,1987,5.0,7,3,4,3,0,3,5,60.0,2,9,9,0,8,15,17,0,Matches
611,Marcos Tavares,br BRA,FW,si NK Maribor,33,1984,5.3,5,2,1,3,1,1,8,12.5,7,4,0,4,1,6,4,1,Matches
612,Alex Telles,br BRA,DF,pt Porto,24,1992,7.0,12,10,8,2,2,7,14,50.0,7,5,2,3,19,31,17,0,Matches
613,Łukasz Teodorczyk,pl POL,FW,be Anderlecht,26,1991,4.3,3,3,0,2,1,0,6,0.0,6,4,1,3,0,3,0,0,Matches
614,Marc-André ter Stegen,de GER,GK,es Barcelona,25,1992,9.0,0,0,0,0,0,0,0,,0,0,0,0,0,0,1,1,Matches
615,Youri Tielemans,be BEL,MF,fr Monaco,20,1997,3.5,9,4,1,8,0,3,7,42.9,4,5,0,5,4,13,3,0,Matches
616,Kieran Tierney,sct SCO,DF,sct Celtic,20,1997,6.0,11,7,6,5,0,4,10,40.0,6,8,1,7,16,27,19,0,Matches
617,Corentin Tolisso,fr FRA,MF,de Bayern Munich,22,1994,5.5,9,4,2,7,0,3,9,33.3,6,8,2,6,3,12,4,1,Matches
618,Jeremy Toljan,de GER,DF,de Dortmund,22,1994,3.0,8,6,4,4,0,5,9,55.6,4,5,2,3,4,12,11,0,Matches
619,Jens Toornstra,nl NED,"MF,FW",nl Feyenoord,28,1989,3.6,5,4,2,3,0,1,7,14.3,6,8,0,8,7,12,4,0,Matches
620,Ömer Toprak,tr TUR,DF,de Dortmund,28,1989,3.8,2,1,1,1,0,1,4,25.0,3,2,2,0,6,8,9,0,Matches
621,Fernando Torres,es ESP,FW,es Atlético Madrid,33,1984,2.3,2,2,1,1,0,0,3,0.0,3,1,0,1,1,3,1,0,Matches
622,Óliver Torres,es ESP,MF,pt Porto,22,1994,1.9,6,4,3,1,2,1,6,16.7,5,3,0,3,0,6,4,0,Matches
623,Duško Tošić,rs SRB,DF,tr Beşiktaş,32,1985,5.6,18,13,11,7,0,9,19,47.4,10,8,4,4,22,40,42,0,Matches
624,Cenk Tosun,tr TUR,FW,tr Beşiktaş,26,1991,5.0,2,0,0,2,0,2,10,20.0,8,4,1,3,3,5,7,0,Matches
625,Almamy Touré,ml MLI,DF,fr Monaco,21,1996,3.0,7,4,2,4,1,1,1,100.0,0,2,1,1,3,10,8,0,Matches
626,Yaya Touré,ci CIV,MF,eng Manchester City,34,1983,2.8,6,2,1,4,1,2,9,22.2,7,2,0,2,1,7,5,0,Matches
627,Adrien Trebel,fr FRA,"MF,DF",be Anderlecht,26,1991,6.0,25,19,8,15,2,10,25,40.0,15,9,0,9,18,43,6,3,Matches
628,Kieran Trippier,eng ENG,DF,eng Tottenham,26,1990,3.0,4,2,1,3,0,2,4,50.0,2,4,0,4,2,6,12,0,Matches
629,Axel Tuanzebe,cd COD,DF,eng Manchester Utd,19,1997,0.2,1,1,0,0,1,0,0,,0,0,0,0,1,2,0,0,Matches
630,Sven Ulreich,de GER,GK,de Bayern Munich,28,1988,11.0,0,0,0,0,0,0,0,,0,0,0,0,0,0,3,1,Matches
631,Samuel Umtiti,fr FRA,DF,es Barcelona,23,1993,9.0,12,7,10,2,0,5,7,71.4,2,9,7,2,20,32,21,1,Matches
632,Cengiz Ünder,tr TUR,"FW,MF",it Roma,20,1997,2.6,4,2,1,3,0,2,9,22.2,7,1,0,1,2,6,2,0,Matches
633,Dayot Upamecano,fr FRA,DF,de RB Leipzig,18,1998,5.0,15,14,12,2,1,5,9,55.6,4,7,3,4,12,27,36,1,Matches
634,Necip Uysal,tr TUR,DF,tr Beşiktaş,26,1991,1.9,9,7,6,3,0,4,7,57.1,3,0,0,0,4,13,9,0,Matches
635,Tomáš Vaclík,cz CZE,GK,ch Basel,28,1989,8.0,0,0,0,0,0,0,0,,0,0,0,0,0,0,6,0,Matches
636,Antonio Valencia,ec ECU,DF,eng Manchester Utd,31,1985,3.7,7,4,2,4,1,3,4,75.0,1,6,0,6,6,13,19,0,Matches
637,Jesús Vallejo,es ESP,DF,es Real Madrid,20,1997,1.0,0,0,0,0,0,0,0,,0,1,1,0,0,0,3,0,Matches
638,Virgil van Dijk,nl NED,DF,eng Liverpool,26,1991,6.0,5,5,3,1,1,1,2,50.0,1,5,3,2,10,15,42,0,Matches
639,Raphaël Varane,fr FRA,DF,es Real Madrid,24,1993,10.4,12,9,10,2,0,8,17,47.1,9,21,13,8,14,26,71,0,Matches
640,Bruno Varela,cv CPV,GK,pt Benfica,22,1994,2.0,0,0,0,0,0,0,0,,0,0,0,0,0,0,1,0,Matches
641,Viktor Vasin,ru RUS,DF,ru CSKA Moscow,28,1988,6.0,6,1,6,0,0,4,10,40.0,6,10,5,5,6,12,36,1,Matches
642,Franco Vázquez,ar ARG,MF,es Sevilla,28,1989,5.5,10,6,3,5,2,4,15,26.7,11,4,0,4,1,11,5,0,Matches
643,Lucas Vázquez,es ESP,"MF,DF",es Real Madrid,26,1991,6.0,17,8,8,9,0,6,16,37.5,10,8,0,8,6,23,12,0,Matches
644,Dylan Vente,nl NED,FW,nl Feyenoord,18,1999,0.2,0,0,0,0,0,0,0,,0,0,0,0,0,0,0,0,Matches
645,Thomas Vermaelen,be BEL,DF,es Barcelona,31,1985,1.0,0,0,0,0,0,0,0,,0,1,0,1,1,1,1,0,Matches
646,Kenneth Vermeer,nl NED,GK,nl Feyenoord,31,1986,1.0,0,0,0,0,0,0,0,,0,0,0,0,0,0,1,0,Matches
647,Marco Verratti,it ITA,MF,fr Paris S-G,24,1992,7.1,26,14,11,11,4,14,25,56.0,11,13,4,9,14,40,5,0,Matches
648,Jan Vertonghen,be BEL,DF,eng Tottenham,30,1987,6.0,14,11,9,4,1,8,12,66.7,4,1,0,1,14,28,25,0,Matches
649,Domagoj Vida,hr CRO,DF,tr Beşiktaş,28,1989,0.2,0,0,0,0,0,0,0,,0,2,2,0,0,0,3,0,Matches
650,Aleix Vidal,es ESP,"FW,MF",es Barcelona,27,1989,1.2,5,4,2,2,1,2,5,40.0,3,0,0,0,5,10,1,0,Matches
651,Arturo Vidal,cl CHI,MF,de Bayern Munich,30,1987,5.3,20,14,9,7,4,8,17,47.1,9,8,2,6,10,30,4,0,Matches
652,Luciano Vietto,ar ARG,FW,es Atlético Madrid,23,1993,0.8,2,2,0,0,2,1,1,100.0,0,0,0,0,1,3,0,0,Matches
653,Mitja Viler,si SVN,DF,si NK Maribor,30,1986,6.0,12,8,7,5,0,10,19,52.6,9,12,6,6,4,16,39,2,Matches
654,Tonny Vilhena,nl NED,MF,nl Feyenoord,22,1995,5.9,8,5,6,2,0,0,8,0.0,8,5,0,5,8,16,8,1,Matches
655,Vinicius,br BRA,MF,cy APOEL FC,31,1986,5.2,7,4,3,4,0,4,11,36.4,7,3,0,3,7,14,10,0,Matches
656,Vitinho,br BRA,FW,ru CSKA Moscow,23,1993,5.2,5,2,3,2,0,2,13,15.4,11,10,1,9,3,8,7,0,Matches
657,Michel Vorm,nl NED,GK,eng Tottenham,33,1983,1.0,0,0,0,0,0,0,0,,0,0,0,0,0,0,0,0,Matches
658,Praxitelis Vouros,gr GRE,DF,cy APOEL FC,22,1995,6.0,8,4,4,4,0,3,9,33.3,6,7,1,6,24,32,23,0,Matches
659,Blaž Vrhovec,si SVN,MF,si NK Maribor,25,1992,4.4,13,10,6,7,0,4,12,33.3,8,3,3,0,5,18,14,0,Matches
660,Šime Vrsaljko,hr CRO,DF,es Atlético Madrid,25,1992,1.0,1,1,1,0,0,0,0,,0,1,1,0,2,3,3,0,Matches
661,Dare Vršič,si SVN,MF,si NK Maribor,32,1984,0.6,1,1,1,0,0,0,2,0.0,2,1,0,1,1,2,0,0,Matches
662,Sandro Wagner,de GER,FW,de Bayern Munich,29,1987,0.6,2,2,1,1,0,1,1,100.0,0,0,0,0,0,2,2,0,Matches
663,Kyle Walker,eng ENG,DF,eng Manchester City,27,1990,7.0,8,5,4,3,1,4,8,50.0,4,7,2,5,11,19,19,1,Matches
664,Kyle Walker-Peters,eng ENG,DF,eng Tottenham,20,1997,0.2,0,0,0,0,0,0,0,,0,0,0,0,0,0,0,0,Matches
665,Victor Wanyama,ke KEN,MF,eng Tottenham,26,1991,0.0,0,0,0,0,0,0,0,,0,0,0,0,0,0,0,0,Matches
666,Boy Waterman,nl NED,GK,cy APOEL FC,33,1984,2.5,0,0,0,0,0,0,0,,0,0,0,0,0,0,1,0,Matches
667,Julian Weigl,de GER,MF,de Dortmund,21,1995,3.6,13,9,6,6,1,3,10,30.0,7,2,0,2,6,19,7,0,Matches
668,Pontus Wernbloom,se SWE,"MF,FW",ru CSKA Moscow,31,1986,5.0,8,6,5,2,1,3,10,30.0,7,8,3,5,10,18,10,0,Matches
669,Timo Werner,de GER,FW,de RB Leipzig,21,1996,3.7,4,3,2,2,0,2,6,33.3,4,2,1,1,1,5,0,0,Matches
670,Georginio Wijnaldum,nl NED,MF,eng Liverpool,26,1990,9.4,14,10,5,8,1,6,15,40.0,9,4,0,4,10,24,12,1,Matches
671,Willian,br BRA,"MF,FW",eng Chelsea,28,1988,4.8,5,3,2,2,1,1,5,20.0,4,5,0,5,1,6,0,0,Matches
672,Harry Winks,eng ENG,MF,eng Tottenham,21,1996,4.7,6,4,2,3,1,3,9,33.3,6,5,1,4,7,13,5,0,Matches
673,Ricky van Wolfswinkel,nl NED,FW,ch Basel,28,1989,1.9,2,0,1,1,0,1,1,100.0,0,2,0,2,1,3,2,0,Matches
674,Taulant Xhaka,al ALB,"MF,DF",ch Basel,26,1991,5.8,13,10,3,10,0,5,11,45.5,6,4,2,2,4,17,12,0,Matches
675,Andriy Yarmolenko,ua UKR,"FW,MF",de Dortmund,27,1989,4.2,6,6,0,4,2,1,6,16.7,5,2,0,2,2,8,2,0,Matches
676,Andrey Yeshchenko,ru RUS,DF,ru Spartak Moscow,33,1984,4.9,17,13,10,6,1,6,17,35.3,11,8,0,8,6,23,27,0,Matches
677,Ashley Young,eng ENG,DF,eng Manchester Utd,32,1985,3.7,6,4,3,2,1,2,3,66.7,1,5,1,4,9,15,10,0,Matches
678,Elvin Yunuszade,az AZE,"DF,FW",az Qarabağ,24,1992,1.4,8,7,8,0,0,4,6,66.7,2,2,2,0,2,10,13,0,Matches
679,Dan-Axel Zagadou,fr FRA,DF,de Dortmund,18,1999,1.0,1,1,1,0,0,0,1,0.0,1,1,1,0,1,2,4,0,Matches
680,Ghayas Zahid,no NOR,"FW,MF",cy APOEL FC,22,1994,5.2,3,2,0,2,1,1,10,10.0,9,5,1,4,3,6,4,1,Matches
681,Davide Zappacosta,it ITA,"DF,MF",eng Chelsea,25,1992,3.9,2,2,1,0,1,1,4,25.0,3,4,0,4,3,5,10,0,Matches
682,Saša Zdjelar,rs SRB,MF,gr Olympiacos,22,1995,2.3,5,2,3,2,0,1,1,100.0,0,4,1,3,9,14,3,0,Matches
683,Tolga Zengin,tr TUR,GK,tr Beşiktaş,33,1983,2.0,0,0,0,0,0,0,0,,0,0,0,0,0,0,1,1,Matches
684,Timur Zhamaletdinov,ru RUS,FW,ru CSKA Moscow,20,1997,1.5,1,1,0,1,0,1,1,100.0,0,2,0,2,0,1,0,0,Matches
685,Piotr Zieliński,pl POL,"MF,FW",it Napoli,23,1994,3.9,2,1,1,0,1,0,4,0.0,4,3,0,3,7,9,2,0,Matches
686,Oleksandr Zinchenko,ua UKR,DF,eng Manchester City,20,1996,1.0,1,1,0,1,0,1,5,20.0,4,0,0,0,1,2,1,1,Matches
687,Andrija Živković,rs SRB,"MF,FW",pt Benfica,21,1996,3.2,4,3,1,3,0,2,5,40.0,3,6,0,6,1,5,1,0,Matches
688,Roman Zobnin,ru RUS,"DF,FW",ru Spartak Moscow,23,1994,1.2,1,1,0,0,1,0,1,0.0,1,1,0,1,0,1,0,0,Matches
689,Oleksandr Zubkov,ua UKR,FW,ua Shakhtar,20,1996,0.0,0,0,0,0,0,0,0,,0,0,0,0,0,0,0,0,Matches
690,Luca Zuffi,ch SUI,MF,ch Basel,27,1990,7.0,9,6,5,3,1,4,11,36.4,7,5,2,3,10,19,6,0,Matches
691,Uroš Đurđević,me MNE,"FW,MF",gr Olympiacos,23,1994,2.3,0,0,0,0,0,0,2,0.0,2,2,0,2,1,1,1,0,Matches
692,Bruno Costa,,,pt Porto,,,1.0,,,,,,,,,,,,,,,,,Matches
